一	弌 壹
丁	𠆤
丂	巧
七	柒
丄	上
丅	下
万	卍 萬
三	叁 弎
上	丄 𠄞
下	丅 厥 𠄟
丌	其
不	不 𠀚 𠙐
与	與
丐	匃
丑	醜
专	專
且	𠀇 𠀃
丕	仳
世	丗 卋
丗	世
丘	丠 㐀 坵 㘳
业	業
丛	叢
东	東
丝	絲
丟	丢
両	兩 两
丢	丟
丣	酉 柳
两	両 兩
严	嚴
並	幷 并 竝
丧	喪
个	個 箇
丬	爿
中	𠁧 𠁩 塚
丰	〈 𡴀 〉 豐
丱	卝
串	串
临	臨
丶	主
丹	丹 𠁿 㣋 𠕑
为	為 爲
主	丶 宔
丼	井
丽	麗
举	舉
乃	廼 𢏩 𢎧 迺 𠄎 𠧤
久	乆
乆	久
乇	虐
么	幺 麼 麽
义	義
之	㞢
乌	烏
乎	虖
乏	𠓟
乐	樂
乔	喬
乕	虎
乖	𦮃 𠁰
乗	乘
乘	乗 𠅞 𠓸
乚	隱
九	玖
也	𠃟 匜
习	習
乡	鄉
书	書
乨	始
乩	稽
买	買
乱	亂
乾	漧 𠄋 亁 干
乿	治
亀	龜
亁	乾
亂	𠧎 𠧏 𠮗 乱
了	了
予	豫 余
争	爭
亊	事
事	亊 叓 𠭏
二	贰 弍 貳
于	扵 於
亏	於 扵 虧
云	員 雲
亓	其
五	伍 𠄡 㐅
井	丼
亗	歲 岁 𡻕
亘	亙
亙	㮓
亚	亞
亜	亞
亝	齊
亞	亜 惡 亚
亡	亾 兦
亢	抗
交	䢒
亦	𠅃
产	產 産
亨	亯 𠅖
亩	畝
享	𠅠
京	亰
亮	亮
亯	享 亨 烹
亰	京
亱	夜
亲	榛 親
亵	褻
亷	廉
亸	嚲
人	𠔽 亻
亻	人
亼	集
亾	亡
亿	億
什	什
仁	忈 忎 𡰥
仂	働
仃	停
仅	僅
仆	僕
仇	讐 讎
从	從
仏	佛
仑	侖
仓	倉
他	她 牠
仙	僊
仝	同
仞	仭
仟	千 阡
令	令
以	㠯
仪	儀
们	們
仭	仞
仮	假
仳	丕
价	價
仺	倉
任	仼
仼	任
份	彬 分
仾	低
仿	倣
伀	彸
企	𠈮
伃	妤
伊	𦯴 𠈽
伍	五
众	眾 衆
优	優
伙	夥
会	會
伛	傴
伜	倅
伝	傳
伞	傘
伟	偉
传	傳
伣	俔
伤	傷
伥	倀
伦	倫
伧	傖
伩	信
伪	偽 僞
伫	佇
伭	玄
伱	你
伲	你
伷	冑 胄
似	𠚦
伽	茄
佇	竚 伫
佈	布
佋	紹
低	仾
佑	祐
体	體 軆
佔	占
佗	它
余	予 餘 馀
佛	仏 𠇛
作	胙 𢓓
佞	侫
你	妳 伱
佣	傭
佥	僉
佬	姆
佰	百
佱	法
併	倂 𠊧 并
佾	𢔍
使	𡥐 𠭆
侁	駪 詵
侂	託
侃	𠈉
侄	姪
侅	賅
來	來 来 徠 耒
侈	𠈎
侉	誇
侌	陰
侎	敉
侖	崙 仑
侚	殉 狥
侠	俠
価	價
侣	侶
侥	僥
侦	偵
侧	側
侨	僑
侩	儈
侪	儕
侫	佞
侬	儂
侭	儘
侮	㑄 㚢 𢘃
侯	𥎦
侶	侣
便	便
俁	俣
係	系
俈	嚳
俊	儁
俌	𥙳
俎	爼
俓	徑 勁
俔	伣
俖	倍
俗	圱
俞	兪
俟	竢
俠	侠
信	伩 㐰 䚱
俣	俁
俥	伡
俦	儔
俨	儼
俩	倆
俪	儷
俫	倈
俭	儉
俯	頫
俱	倶
俲	效
俻	備
倀	伥
倂	併
倅	伜
倆	俩
倈	徠 勑 俫
倉	仺 仓
個	个 箇
倍	俖
倏	倐
倐	倏
們	们
倖	幸 囟
倘	儻
借	藉
倣	仿
値	值
倫	倫 伦
倶	俱
倹	儉
债	債
值	値
倾	傾
偁	穪 稱
偃	㫃
假	仮
偉	伟
偊	踽
偎	渨
偐	贋 贗
偒	蕩
停	仃
健	徤
偪	逼
偬	傯
偰	𥝁
側	侧
偵	侦
偷	偸
偸	偷
偹	備
偺	昝 咱 喒
偻	僂
偽	伪
偾	僨
偿	償
傁	叟 叜 墰
傌	罵
傍	旁
傏	搪
傑	杰
傖	伧
傘	繖 伞
備	𠈍 俻 备
傜	徭
傢	家
傤	儎
傥	儻
傧	儐
储	儲
傩	儺
傭	佣
傯	偬
傳	传
傴	伛
債	债
傷	伤
傻	儍
傽	慞
傾	倾
僂	偻
僅	仅
僈	𣍑
僉	𠑲 佥
僊	仙
働	仂
像	象
僑	侨
僕	䑑 仆
僚	僚
僞	偽 伪
僣	僭
僥	徺 侥
僨	偾
僭	僣
僱	雇
價	价
儀	仪
儁	俊
儂	侬
億	亿
儆	警
儈	侩
儉	𠈏 俭
儌	僥
儍	傻
儎	傤 載
儐	傧
儓	檯 枱
儔	𠍻 俦
儕	侪
儘	尽
儛	㒇
償	偿
儡	酹
優	优
儭	襯
儲	储
儶	㒞
儷	俪
儸	㑩
儺	𩙎 傩
儻	倘 傥
儼	𡅝 俨
儿	兒
兀	兀
允	㽙
兂	簪
兇	凶
光	灮 炗 𤎫 𠈑 𤉭
克	𠧳 𡱀 𠅔 𠅡 𠧻 剋
兌	兑
兎	兔
児	兒
兑	兌
兒	𠒆 儿
兔	兎
兕	𠒅 𧰽
兖	兗
兗	兖
兘	始
党	黨
兢	𠓆
兦	亡
內	𡗠 内
全	𠓴 㒰
兩	両 㒳 两
兪	俞
八	捌
公	㒶
六	六 陸
兮	𠔃
兰	蘭
共	𦱹
兲	天
关	關
兴	興
兵	𠈯 𠡿
其	丌 亓
典	𥮏
兹	玆 茲
养	養
兼	𥡝
兽	獸
兿	藝
冁	囅
冂	坰 冋
冄	冉
内	內
円	圓
冈	岡
冉	冄
冊	册
冋	冂 坰
册	冊
冐	冒
冑	胄 伷
冒	冒 𡈘 𡇾
冗	宂
写	寫
军	軍
农	農
冝	宜
冢	塚
冤	寃
冦	寇
冨	富
冩	寫
冪	羃 鼏 幂
冫	氷 冰
冬	鼕 𣆼 𣅈 𠘀 𠔙 𠘗
冯	馮
冰	氷 冫 𣲝
冱	沍
冲	沖 衝
决	決
况	況
冷	冷
冻	凍
冽	洌
净	淨 凈
凂	浼
凃	塗
凄	淒
凅	涸
准	準
凈	淨 净
凉	涼
凋	雕
凌	凌
凍	冻
减	減
凑	湊
凔	𠖸
凖	準
凘	𠗧
凛	懔 凜
凜	凛
几	幾
凡	凢 凣
凢	凡
凣	凡
凤	鳳
処	處 䖏
凨	風
凫	鳧 鳬
凬	風
凭	憑
凯	凱
凱	凯
凳	櫈
凴	憑
凶	兇 㐫 𣧑
凷	塊
凹	𠕄
出	岀
击	擊
凼	幽
函	凾 圅
凾	函 圅
凿	鑿
刀	刂
刂	刀
刃	刄
刄	刃
刅	創
分	份
切	切
刈	苅 𠛄
刊	刋
刋	刊
刍	芻
刏	𣱚
划	劃 畫
刓	园
刔	抉
列	列
刘	劉
则	則
刚	剛
创	創
初	䥚
删	刪 𠛹
別	𠔁 别
刦	劫 刧
刧	刦 劫
刨	鉋
利	利 𥝢 𥝤
刪	删
别	別
刬	剗
刭	剄
刮	颳
刱	剏 創
刴	剁
制	𠜔 𠝦 𠝁 𠛐 製
刷	㕞
刹	剎
刺	刾 莿
刻	𠞫
刼	劫
刽	劊
刾	刺
刿	劌
剀	剴
剁	刴
剂	劑
剃	鬀
剄	刭
則	𠟻 𠟭 𠞋 𠟔 则
剈	𠜟
剉	銼
剋	尅 克
剌	巤
前	歬 𣦃
剎	刹
剏	刱
剐	剮
剑	劍
剔	𠜓 𠠡
剖	𠞌
剗	剷 刬
剙	創
剛	𠜛 𠇝 𠇙 刚
剝	𠚪 剥
剣	劍
剤	劑
剥	剝
剦	閹
剧	劇
剩	剰 賸
剪	翦
剮	剐
剰	剩
剱	劍
割	𠛛 㓣 𠛷
剳	箚 劄
剴	剀
創	剙 戧 𠝀 𠛲 瘡 刅 刱 创
剷	鏟 剗
剿	勦 𠞰
劃	𠟱 划
劄	剳
劆	鐮
劇	剧
劈	擗
劉	鎦 𠭱 刘
劊	刽
劌	刿
劍	劒 剑
劎	劔
劏	㓥
劑	剤 𠜸 剂
劒	劍
劓	㓷
劔	劍 劎
劚	㔉
力	力 𠠲
劝	勸
办	辦
务	務
劢	勵 勱
劣	劣
动	動
劫	刦 刧 刼
励	勵
劲	勁
劳	勞
労	勞
劵	券
効	效
势	勢
勁	俓 劲
勃	艴
勄	敏
勅	勑 敕
勋	勛
勑	倈 勅 敕 徠
勒	勒
動	㣫 𨔝 动
勖	勗
勗	勖
務	务
勚	勩
勛	勲 勳 勋
勝	𠢧 𠅫 𢾶 胜
勞	勞 𠣁 𢥒 劳
勠	𠝧
勢	势
勤	懃 瘽
勦	剿
勧	勸
勩	勚
勰	協 恊 脅
勱	劢
勲	勛
勳	勛
勵	劢 励
勸	勧 劝
勹	包
勻	匀
勽	㲒 菢
勾	句
匀	勻
匃	丐 匄
匄	匃
包	勹
匆	悤 怱
匈	胸 胷
匊	𦥑 掬
匋	陶
匏	瓟
化	𠤎 𠯒 𠏁
北	北 𧉥
匘	腦
匙	鍉
匚	𠤬
匜	也
匝	帀 迊
匦	匭
匧	篋
匨	藏
匭	匦
匮	匱
匯	滙 汇
匱	樻 鐀 櫃 饋 匮
匳	奩
匵	櫝
匸	放
匹	疋
区	區
医	醫
匿	匿
區	区
十	拾 拾
千	仟
卄	廿
卆	卒
升	昇
卉	芔
卋	世
卍	卐 万 萬
华	華
协	協
卐	卍
卒	卆 䘚
卓	𠤞 𠤚 𠤟 𢂚 棹
協	恊 旪 勰 协
单	單
卖	賣
南	𡴖 𡴟
単	單
博	愽
卛	率
卜	𠁡 蔔
卝	磺
占	佔
卢	盧
卣	𠧪
卤	滷 鹵
卧	臥
卩	部 節 㔾
卫	衛
卬	卭
卭	卬
卮	巵
卯	戼 𩇨 𩇧 𤕰 𦕔
印	𠘄
危	𡵁
即	卽
却	卻
卵	卵
卷	捲
卸	缷
卹	恤
卻	却
卽	即 皍
厂	廠
厄	阨 戹
厅	廳
历	歷 厲 曆
厉	厲
压	壓
厌	厭
厍	厙
厎	砥
厐	龐 龎
厓	崖
厕	廁 厠
厖	龐 庬
厗	銻
厘	釐
厙	厍
厚	垕 𡦩
厛	廳
原	𠪥 𨘡 𠪰
厠	廁 𨕟 厕
厢	廂
厣	厴
厤	曆
厥	氒 〈 氏 下 可 〉 𨈑 𨈐 𣅞
厦	廈
厨	廚 𢊍
厩	廐 廄
厪	廑
厭	厌
厮	㒋 廝
厰	廠
厲	历 厉
厳	嚴
厴	厣
厵	源
厶	私 某
厷	肱
厸	鄰
厹	叴
县	縣
叁	參 三 叄
参	參
參	參 𠫰 朁 叅 薓 参
叄	參 叁
叅	參
叆	靉
叇	靆
叉	釵
及	𢎜 𨕤
友	㕛 𠬺 𦐮 𦫹 𦐯
双	雙
反	𠬡
収	收
发	發 髮
叓	事
叔	𡭫 𠁮 𢆑 尗
受	𠭧
变	變
叙	敍 敘
叜	叟 傁 溞
叝	告
叟	叜 傁 墰
叠	曡 疊
叡	睿 壡 䜭
叢	樷 丛
口	𠮚 𠙵
古	𠖠 𡇣
句	句
叨	饕
只	止 子 衹 隻
叫	呌
可	歌 厥
台	臺 嗣 台 檯 颱
史	㕜
叴	厹
叵	尀
叶	葉
号	號
司	𤔲
叹	嘆
叽	嘰
吁	籲 𠮲
吃	喫
吅	訟
合	閤
吊	弔
吋	寸
同	仝 衕
后	后 後
吏	吏
向	嚮 曏
吒	咤
吓	嚇
吕	呂
吗	嗎
吚	咿
君	𠱩 𠱭
吝	吝 恡 悋 𠲲 𠯌 𠴽
吞	呑
吟	唫 㕂
吣	唚
否	𠘶
吨	啍 噸
含	唅
听	聽 哂
启	啓 啟
吲	哂
吳	呉 虞 𡗿 𡗾 吴
吴	吳
吶	訥 呐
吸	噏
吹	龡
吻	呡 肳 㖧 𠞍
吾	𠮣
吿	告
呂	呂 吕
呃	阨
呆	騃 獃
呈	㞷
呉	吳
告	吿
呌	叫
呐	吶
呑	吞
呒	嘸
呓	囈
呕	嘔
呖	嚦
呗	唄
员	員
呙	咼
呛	嗆
呜	嗚
呠	歕 噴
呡	吻
周	週 𠱬 𠄗
呩	嗜
呪	咒 詋
呱	哌
呴	詬
呵	訶
呼	謼 𠰗 戲
咀	嘴 觜
咂	𠯗
咊	和 龢
和	龢 咊
咏	詠
咒	呪
咙	嚨
咛	嚀
咝	噝
咠	舙
咤	吒
咥	嘻
咨	谘 嗞 諮
咩	哶
咬	齩
咮	胄
咯	詻
咱	偺 喒
咲	笑
咳	欬 孩
咷	啕
咸	鹹
咼	呙
咽	咽 嚥
咿	吚
哂	吲 听
哄	閧
哉	才
哌	呱
响	響
哑	啞
哒	噠
哓	嘵
哔	嗶
哕	噦
哗	嘩
哙	噲
哜	嚌
哝	噥
哟	喲
員	云 员
哥	歌
哦	誐
哲	喆 悊 嚞
哴	喨
哶	咩
哼	苛
唁	喭 囐
唄	呗
唅	含
唇	脣
唉	誒 欸
唊	硤
唐	啺 𣉺 𡃯
唖	啞
唚	吣
唛	嘜
唝	嗊
唠	嘮
唡	啢
唢	嗩
唤	喚
唧	喞
唫	吟
唬	諕 猇 虓
唱	𪛋
唷	唹
唾	涶
啃	齦
商	𡅟 𠾃 𡂦 𠿧 𡃬 𡄚 𠹧 𧶜
啊	阿
啍	吨
啎	忤
問	𠳅 问
啓	啟 启
啔	啓
啕	咷
啖	啗 㗖 噉
啗	啖 㗖 噉
啚	𠴿
啜	欼 諁 歠
啞	唖 瘂 哑
啟	啓 启
啢	唡
啣	㘅
啧	嘖
啨	情
啬	嗇
啭	囀
啮	嚙
啯	嘓
啰	囉
啴	嘽
啸	嘯
啺	唐
啼	嗁 謕
喂	餧 餵
喃	嫐 諵
善	譱 𦎍 𠾄 𧮟
喆	哲
喇	喇
喎	㖞
喏	諾
喐	郁
喒	昝 偺 咱
喚	唤
喜	憙 憘 𢐭 歖
喞	唧
喟	𠷝
喧	吅 諠
喨	哴
喩	喻
喪	𡂤 𡴧 𡂧 𦦦 𡚏 丧
喫	吃
喬	乔
喭	唁 𧧑
單	単 单
喰	餐
喲	哟
営	營
喷	噴
喻	喩
喽	嘍
喾	嚳
喿	噪
嗀	嗀
嗁	啼
嗄	𠷚
嗅	齅
嗆	呛
嗇	𠻮 𤲝 𤳋 𤲷 啬
嗉	膆
嗊	唝
嗎	吗
嗒	㗳
嗚	呜
嗜	呩
嗞	咨 諮
嗟	𨲠 差
嗣	台 孠
嗥	嚎 嘷
嗩	唢
嗫	囁
嗬	呵
嗳	噯
嗶	哔
嗻	處
嗽	瘶
嘆	𡂥 歎 叹
嘈	䜊
嘍	謱 喽
嘎	尜
嘑	呼
嘓	啯
嘔	慪 呕
嘖	啧
嘗	甞 尝
嘘	噓
嘜	唛
嘤	嚶
嘨	嘯
嘩	譁 哗
嘮	唠
嘯	嘨 歗 啸
嘰	叽
嘱	囑
嘴	咀 觜
嘵	哓
嘷	嗥
嘸	呒
嘻	咥
嘼	畜
嘽	啴
嘿	默
噁	恶
噂	譐
噅	噕
噉	㗖 啖 啗
噏	吸
噐	器
噑	嚎
噓	嘘
噕	噅
噚	㖊
噜	嚕
噝	咝
噠	哒
噥	哝
噦	𧬨 哕
器	噐 𡄛
噪	譟 喿
噫	𢤏
噯	嗳
噲	哙
噴	呠 歕 喷
噸	吨
噹	当
嚀	咛
嚇	吓
嚌	𠴧 哜
嚎	嗥 噑
嚏	嚔
嚔	嚏
嚕	噜
嚙	齧 啮
嚚	𠽺 𡅚 𡓶 𠿦
嚞	哲
嚠	瀏
嚢	囊
嚣	囂
嚥	咽 咽
嚦	呖
嚨	咙
嚬	顰
嚮	向 𡩉 𡪥
嚲	亸
嚳	俈 喾
嚴	厳 𡅾 严
嚵	饞
嚶	嘤
嚹	𡅈
嚻	囂
囀	啭
囁	讘 嗫
囂	𠽸 嚣
囅	冁
囈	呓
囉	啰
囊	嚢 𢑿
囌	蘇
囏	艱
囐	唁
囑	嘱
囓	嚙 齧
囗	國 圍
囘	回 囬
四	𦉭 肆
回	囬 囘 廻
囟	𠙷 𦞤 䪿 顖 倖 幸
因	𤇀
团	團
団	團
囤	𥫱
囦	淵
囪	囱
囬	囘 回
园	刓 園
囮	𡈙 諤
囯	國
困	𣏔 睏
囱	囪
囲	圍
図	圖
围	圍
囵	圇
囶	國
囹	囹
固	怘
国	國
图	圖
圀	國
圅	函 凾
圆	圓
圇	囵
圈	圏
國	圀 囗 囶 𢧌 䆐 囯 国
圍	囲 囗 围
圎	圓
圏	圈
園	园
圓	圎 圆
圕	圖
圖	図 𡈖 𡇴 圕 图
團	団 团
圢	䵺 町
圣	聖
圧	壓
圫	墺
圬	杇
圭	珪
地	埊 𨻐 埅 𠏂 嶳
圱	俗
圹	壙
场	場
圻	垠
址	阯
坂	阪
坃	壎
坆	墳
均	韻
坋	坌
坌	坋
坎	埳
坏	坯 壞
坐	座 㘸
坑	阬
坓	型
坕	經
坖	忌
块	塊
坚	堅
坛	壇 罈
坜	壢
坝	壩
坞	塢
坟	墳
坠	墜
坣	堂
坤	巛 𠔜 堃
坫	店
坭	泥
坯	壞 坏
坰	冂 冋
坵	丘
垂	埀 𡍮 𠄒 𠂹 𠣔
垄	壟
垅	壠
垆	壚
型	坓
垐	堲
垒	壘
垓	陔
垔	陻 堙
垕	厚
垛	垜
垜	垛
垠	圻 㙬 𡊷 𡏴
垣	𩫧
垦	墾
垩	聖 堊
垫	墊
垭	埡
垱	壋
垲	塏
垴	堖
垵	埯
垻	壩
埀	垂
埅	地
埇	甬
埊	地
埒	埓
埘	塒
埙	塤
埚	堝
埜	野
域	㽣 䧕 𢨊 譽
埡	垭
埯	垵
埰	采
埳	坎
埶	蓺 秇 藝
執	执
基	𡉝 抍 拯
埼	崎
埽	掃
堂	坣 㙶
堃	坤
堅	坚
堆	𠂤
堇	菫
堈	缸 罁
堊	聖 垩
堑	塹
堕	墮
堖	垴
堘	塍
堙	垔 陻
堝	埚
堤	隄
堦	階
堭	隍
堯	𡋰 尧
報	报
堲	垐
場	塲 场
堺	界
堿	鹼 鹻
塆	壪
塈	墍
塊	凷 块
塋	茔
塌	𡓲
塍	堘
塏	垲
塐	塑
塑	塐
塒	埘
塔	墖 㙮
塗	凃 涂
塚	塚 中
塜	塳
塞	塞
塟	葬
塡	填 窴 𥧑
塢	隝 隖 鄔 坞
塤	壎 埙
塩	鹽
填	塡
塲	場
塳	塜
塵	𦧄 𡐪 尘
塹	壍 堑
塾	孰
墈	磡
墉	𩫱 𩫃
墊	垫
墍	塈 𡉙 𡍳
墖	塔
増	增
墙	牆 墻
墜	坠
墝	磽
墤	隤
墫	樽 罇
墮	堕
墰	罈 壜 傁
墳	坆 坟 𡏶
墺	𡋮 𡋸 圫 𡌱
墻	牆 廧 墙
墾	垦
壇	坛
壈	𡒄
壊	壞
壋	垱
壌	壤
壍	塹
壎	塤 坃 壦
壐	璽
壓	圧 压
壘	塁 垒
壙	圹
壚	垆
壜	墰 罈
壞	壊 𡎯 坏
壟	壟 垄
壠	垅
壡	叡
壢	坜
壤	壌 𦦶
壦	壎
壩	垻 坝
壪	塆
壮	壯
壯	壮
声	聲
売	賣
壳	殼 㱿 殻
壶	壺
壷	壺 𠻭
壸	壼
壹	搋 一 弌 夁 𡔾 𡕋 𡕍
壺	壷 壶
壻	婿
壼	壸
壽	寿 夀 𦓃 𦓂 𠭵 𠷎
夀	壽 寿
夁	壹
夃	沽
处	處
夅	降
备	備
変	變
夊	攵 終 綏
夌	陵
复	復 複 覆
夏	𡔰 𠍺 昰 𡕾
夐	敻
外	𡖄 舀
夘	卯
夙	宿 𠈇 𠉦 𣦽
多	夛 𡖇 𡖈
夛	多
夜	亱 𡖍 𠙑 𠙇
够	彀 夠
夠	够 彀
夢	梦 夣
夣	夢
夥	伙
大	𠘲
天	𠀡 𠀘 𦴞 兲 靝 𠕹
夭	殀
夯	䂫
夳	泰
头	頭
夶	比
夷	𡰥
夸	誇
夹	夾
夺	奪
夾	夹
奁	奩
奂	奐
奇	竒
奈	柰
奉	𠬻 𢱵
奋	奮
奌	點
奎	㚝 奞
奏	𡙹 𡲯 𡴨 𢽥
奐	奂
契	契
奔	犇
奕	弈
奖	奬 獎
奘	弉
奞	㚝 奎
奥	奧
奧	奥
奨	奬
奩	匳 奁
奪	𡙸 𡜎 夺
奬	奖
奭	𡚐
奮	奋
女	女 𠨰
奴	㚢
奶	嬭 妳
奸	姦
她	他 姐
奼	姹
好	𡥆 𡚽 𩐔
妆	妝
妇	婦
妈	媽
妊	姙
妍	姸
妒	妬
妘	𡤀
妙	玅
妝	粧 妆
妤	伃
妩	嫵
妪	嫗
妫	媯 嬀
妬	妒
妳	你 奶 嬭
妻	𡜌 𡜈
姆	姥 佬
姉	姊
姊	姉
始	𠃭 乨 兘 𠙉
姍	㛽 姗
姐	她 毑
姒	㚶
姓	𤯧 𤯣
姗	姍
姘	嬪
姙	妊
姜	薑
姢	娟
姣	㚣
姥	姆
姦	𢙶 奸
姪	侄
姫	姬
姬	姫 㚦
姶	㛕
姸	妍
姹	奼
姻	婣
威	𤰴 𤱫
娄	婁
娅	婭
娆	嬈
娇	嬌
娈	孌
娘	孃
娚	喃
娛	娱
娟	姢
娠	㛛 煖
娩	㝃
娬	嫵
娭	毐
娯	娛
娱	娛
娲	媧
娴	嫻
娿	婀
婀	娿
婁	𡜰 𡇔 𡝨 娄
婣	姻
婦	𢽰 媍 妇
婬	淫
婭	娅
婳	嫿
婴	嬰
婵	嬋
婶	嬸
婾	媮
婿	聟 壻
媆	嫩 嫰
媍	婦
媚	𡡚
媧	娲
媪	媼
媭	嬃
媯	嬀 妫
媼	媪
媽	妈
媿	愧 醜
嫉	𡜱
嫋	嬝
嫐	喃
嫒	嬡
嫔	嬪
嫕	嫛
嫗	妪
嫛	嫕
嫩	媆 𡞾 嫰
嫫	嬷
嫰	媆 嫩
嫱	嬙
嫵	娬 妩
嫺	嫻
嫻	嫺 娴
嫿	婳
嬀	媯 妫
嬃	媭
嬈	娆
嬋	婵
嬌	撟 娇
嬙	嫱
嬝	裊
嬡	嫒
嬢	娘
嬤	嬷
嬪	𡜷 𡝏 姘 𡣑 𡤁 嫔
嬭	𡇲 奶 妳
嬰	孾 婴
嬲	惱
嬷	嫫 嬤
嬸	婶
嬾	懶
孀	霜
孃	娘
孌	𡢛 娈
子	㜽 𢀈 𢀉 𡐫 𣕓 只
孔	𡤿
孕	𣎜
字	𡥜 𥤪
存	𠩯
孙	孫
孚	孵 𤓽
孛	柏 栢
孠	嗣
季	𡥞 𡦠 𩐄 𩐖
学	學
孩	咳
孪	孿
孫	孙
孭	𧴯
孰	塾
孳	孶 𡥝
孵	孚
孶	孳
學	斈 学
孼	孽
孽	孼
孾	嬰
孿	孪
宁	寧
宂	冗
它	牠 佗
宄	𡧫 𡧌 𠬚
宅	宅 𡧪 㡯
宇	穻
守	𡬮 𡬴
完	烟 煙 寬
宍	肉
宐	宜
宔	主
官	𠕍
定	㱏
宛	惌
宜	冝 𡪀 𡨆 𠣨 宐
宝	寳 寶
实	實
実	實
宠	寵
审	審
宣	𡩦
宪	憲
宫	宮
宮	宫
宰	𡪤 𡨧 𠈾
宲	實
宴	讌
宵	𣆺
家	傢 𠖔 𡩅 𡧚
宷	審
容	𠕺
宻	密
宼	寇
宽	寬
宾	賓
宿	㝛 夙
寃	冤
寅	𦦚 𡓵 㝙 𢁐 𡩪
密	宻
寇	宼
寈	靑
富	冨
寍	寧
寑	寢
寒	𡫮 𡫾
寓	庽
寔	實
寕	寧 寜
寗	甯
寘	置
寚	寶 宝 寳
寛	寬
寜	寧 寕
寝	寢
察	詧
寠	窶
寡	關
寢	𡨦 𡫒 寑 寝
實	実 宲 𡾍 寔 实
寧	寍 𡨴 宁
寨	砦
審	宷 审
寫	冩 写
寬	寛 完 宽
寮	寮
寳	寶 宝
寴	親
寵	𠖥 宠
寶	宝 寳 寚 𠋾 珤
寸	吋
对	對
寻	尋
导	導
寿	壽 夀
尀	叵
封	𡉘 𡊽
専	專
尃	旉 敷
尅	剋
将	𤕭 將
將	𤕭 𢪇 将 畺
專	耑 𠧡 𠧢 𡴁 专
尉	㷉 熨
尋	𡬻 寻
對	对
導	𡭎 导
尒	爾 尔
尓	爾
尔	尒 爾
尗	叔
尘	塵
尙	尚
尚	尙
尛	麼
尜	嘎
尝	嘗
尠	鮮
尢	尣
尣	尢
尤	怣
尥	尦
尦	尥
尧	堯
尨	龍 狵
尩	㑌
尪	尫
尫	尪
尭	堯
尰	腫
尲	尷
尴	尷
尷	尲 尴
尸	屍
尹	𢃵 𢃹 𢃁 𢃂
尻	䯌
尽	盡 儘
尾	𡱕 𡱓 𡲵
尿	尿 溺
层	層
屃	屓
居	㞐 㝒
屆	曁 艐 届
屈	𡕜 𡲶
屉	屜
届	屆
屋	𦤿
屍	尸
屏	摒
屓	屃
展	㠭
屛	摒
屜	𡲕 屉
属	𡱆 屬
屡	屢
屢	屢 𡜸 屡
屣	蹝 躧
層	层
履	履 𡲟 𩕎
屦	屨
屨	屦
屩	蹺
屬	属 𡱆
屭	屓
屮	草
屰	戟
屿	嶼
岁	亗 歲 𡻕
岂	豈
岐	歧 𨙾 㟚
岖	嶇
岗	岡 崗
岘	峴
岙	嶴
岚	嵐
岛	島
岡	𠆼 崗 冈
岨	砠
岩	巖
岫	峀
岭	岺 嶺
岳	嶽
岺	岭
岽	崠 崬
岿	巋
峀	岫
峄	嶧
峒	洞
峡	峽
峣	嶢
峤	嶠
峥	崢
峦	巒
峨	峩
峩	峨
峭	陗
峯	峰
峰	峯
峴	岘
島	嶋 岛
峺	硬
峽	峡
崂	嶗
崃	崍
崄	嶮
崇	嵩
崈	崇
崋	華 𡼙
崍	崃
崎	埼
崐	崑
崑	崐
崒	崪
崔	磪
崕	崖
崖	厓
崗	岡 岗
崘	崙
崙	崙 侖 崘
崟	嶔
崠	岽
崢	峥
崧	嵩
崩	𨹹
崪	崒
崬	岽
崭	嶄
嵆	嵇
嵐	嵐 岚
嵗	歲
嵘	嶸
嵚	嶔
嵜	崎
嵝	嶁
嵠	谿
嵩	崇 崧
嵯	嵳
嵳	嵯
嶁	嵝
嶃	磛
嶄	巉 崭
嶇	㠊 岖
嶋	島
嶌	島
嶎	蔚
嶔	崟 嵚
嶗	崂
嶝	磴
嶠	峤
嶢	峣
嶧	峄
嶮	崄
嶳	地
嶴	岙
嶸	嵘
嶺	嶺 阾 岭
嶼	屿
嶽	岳 𡶓 𡶳 𡴳
巅	巔
巉	嶄
巋	岿
巌	巖
巍	魏
巒	峦
巔	巓 巅
巖	巌 岩
巛	坤 川
巜	澮
川	巛
州	𠄓 𠃕 𠛏 𣧓
巠	𡿱
巡	廵 順
巢	巣
巣	巢
巤	鬣 剌
工	𢀚 㣉 𠜝
巧	丂 𢩨
巨	鉅 𢀑 㠪 𠫕
巩	鞏
巫	𢍮 𢀣
差	嗟 𢀩
巯	巰
巰	巯
己	𢀒
巴	笆
巵	卮
巺	巽
巻	捲
巽	巺 𢁅
帀	匝 迊
币	幣
布	佈 㱛
帅	帥
帆	㠶 𩗋 拚
师	師
帋	紙
希	稀 𠬹
帏	幃
帐	帳
帒	袋
帘	簾
帙	袠
帚	菷 箒
帜	幟
帝	𢂇 𠫦
帡	帲
帥	䢦 帅
带	帶
帧	幀
師	𠵀 𠦵 𢂖 𩇱 师
帬	裙
席	蓆 𠩛 𥔆
帮	幫 幇
帯	帶
帰	歸
帱	幬
帲	帡
帳	賬 帐
帶	帯 带
帷	𠥎
帻	幘
帼	幗
幀	帧
幂	鼏 冪
幃	𠥎 帏
幇	幫 帮
幕	幙
幗	帼
幘	帻
幙	幕
幚	幫
幞	襮
幟	旘 帜
幡	旛
幢	橦
幣	币
幤	幣
幫	帮 幇
幬	帱
幱	襴
干	乾 幹
平	𤔁 𠀭
年	秊 𠫺
幵	开
并	並 幷 竝 併
幷	並 并 竝
幸	倖 㚔 𠂷 囟
幹	干
幺	么
幻	㕕
幼	𠣎
幽	凼
幾	𢆻 𢆼 几
广	廣
庁	廳
広	廣
庄	莊
庅	麼 麽
庆	慶
床	牀
庐	廬
庑	廡
库	庫
应	應
店	坫
庙	廟
庞	龐
废	廢
度	廓 𡧪 㡯
座	坐
庫	库
庬	厖
庵	菴
庶	庻 𤈲 𠦜 𠪌 𠩽 𠪛
康	𠭳
庸	㐯 𠆌
庺	松
庻	庶
庼	廎
庽	寓
庾	斞
庿	廟
廀	廋
廁	厠 厕
廂	厢
廃	廢
廄	廐 厩
廈	厦
廉	廉 磏 槏 𢋯 𢉧
廊	廊
廋	廀
廌	豸
廏	廄 𠤙
廐	廄 厩
廑	厪
廓	廓 𢌓
廕	蔭
廚	厨
廝	㒋 厮
廟	庙 庿
廠	厰 厂
廡	庑
廢	廃 废
廣	广
廧	墻 牆 𢋾
廩	稟 𢈺 廪
廪	稟 廩
廬	廬 庐
廰	廳
廱	雝
廳	廰 厅
廵	巡
廸	迪
廹	迫
廻	回 迴
廼	乃 迺
廽	回
廾	廿
廿	廾 卄
开	幵 開
弁	辨
异	異
弃	棄
弄	弄 瘧
弇	𢍔 𥦦
弈	奕
弉	奘
弊	𡚁
弌	搋 一 壹
弍	二 貳
弎	三
弑	弒
弒	弑
弔	吊
引	㧈
弟	𠂖 𢦢
张	張
弡	張
弢	韜
弥	彌
弦	絃
弪	弳
弭	𢏱
弯	彎
弳	弪
張	弡 张
強	强 彊
弹	彈
强	強 彊
弼	𠡂 㢸 𠨒 𢘍 𢏇 𢼥
弾	彈
彀	够 夠
彂	發
彈	𢎝 弹
彊	强 強
彌	𢑀 弥
彎	弯
彐	彑
彑	彐
归	歸
当	當 噹
录	錄 録
彗	篲
彙	彚 汇
彚	彙
彛	彝
彜	彝
彝	彛 𦇚 𢇏 𧤋 彞
彞	彝
彟	彠
彠	彟
彥	彦
彦	彥
彨	彲
彫	㓮 雕 鵰
彬	份 斌
彲	彨
彷	仿 髣 徬
彸	伀
役	𠈿
彻	徹
彿	髴
往	徃 𢔎 𨓹
征	徰 徵
徂	𡲂 𡲡
徃	往
径	徑
律	律
後	𨒥 𢔏 后
徑	俓 勁 径
徒	𨑒 𠫠
従	從
徕	徠
得	𢔶 䙷 𢔨
徙	𡕝 𨗬 𡲴
從	従 从
徠	來 倈 勑 徕
御	馭 𢓷 𢕜 禦
徤	健
徧	遍
徨	遑
復	覆 𢕛 𠣸 复
徬	彷
徭	傜
徰	征
徳	德
徴	徵
徵	𡈼 𢽡 𢾷 𢽠 征
德	惪 悳
徹	𢖉 𢕹 澈 彻
徺	僥
徽	𢾰
心	㣺 忄
忄	心
忆	憶
忈	仁
忌	坖
忍	㣼
忎	仁
忏	懺
志	誌 𢗍 志
応	應
忞	暋
忤	啎 迕
忧	憂
忭	昪
忰	悴
念	念
忻	欣
忼	慷
忾	愾
怀	懷
态	態
怂	慫
怃	憮
怄	慪
怅	悵
怆	愴
怌	懷
怒	怒 𢘂
怘	固
怜	憐
思	恖 𠂺 𡴓 𢍄
怣	尤
怨	𢘖 𠨝 𢛪 𢘔 𢘈
怩	𢘒
怪	恠
怱	匆 悤
怳	恍
怸	悉
总	總
怼	懟
怿	懌
恂	悛
恆	𢛢 𠄨 恒
恊	協 勰
恋	戀
恍	怳
恐	𢖶 𢙢
恒	恆
恕	㣽
恖	思
恠	怪
恡	吝 悋
恤	賉 卹
恥	耻
恩	摁
息	𧪩
恳	懇
恵	惠
恶	惡
恸	慟
恹	懨
恺	愷
恻	惻
恼	惱
恽	惲
恿	慂
悁	懁
悅	悦
悉	𢚊 𢝕 怸
悊	哲
悋	吝 恡
悐	惕
悔	𠧩
悚	𢷜 𢥠
悛	恂
悞	誤 悮
悟	𢛤
悠	滺
患	𢤒 𢡙 𢠶
悤	匆 怱
悦	悅
悪	惡
悫	慤 愨
悬	懸
悭	慳
悮	悞
悯	憫
悳	德
悴	忰
悵	怅
悶	㥃 懣 闷
悽	淒
惄	𧗂
情	𢚏 啨
惇	𥫉 敦
惊	驚
惌	宛
惎	𢗏
惕	惖 悐
惖	惕
惛	惽
惝	𢠵
惟	𢛧
惠	恵 𦻇 𢡘 𢞯 ①
惡	惡 亞 恶
惧	懼
惨	慘
惩	懲
惪	德
惫	憊
惬	愜
惭	慚
惮	憚
惯	慣
惰	𢢠 𢞑
惱	嬲 恼
惲	恽
惷	蠢
惺	𢜫 醒
惻	𢝔 恻
惽	惛
愆	𠐨
愈	癒 愉 瘉
愉	愈
愍	㥸 憫
愛	𤔤 𢟪 𢛭 爱
愜	惬
感	𢦡
愠	慍
愤	憤
愦	憒
愧	媿
愨	慤 悫
愬	訴
愳	懼
愴	怆
愷	恺
愻	遜
愼	眘 𡴜 㥲 昚
愽	博
愾	忾
愿	願
慁	㥵
慂	恿
慄	慄 栗
慈	㤵
態	态
慍	愠
慎	愼
慑	懾
慕	𢟽
慘	惨
慙	慚
慚	慙 惭
慞	傽
慟	恸
慣	惯
慤	愨 悫
慪	嘔 怄
慫	怂
慭	憖
慮	虑
慳	悭
慶	𢞢 𢙎 庆
慷	忼
慺	𢡌
慼	慽
慽	慼
慾	欲
憂	𠪍 𨗫 懮 忧
憅	慟
憇	憩
憊	惫
憋	𢠳
憐	憐 㥕 怜
憑	凴 𠗦 凭
憒	愦
憔	顦
憖	慭
憘	喜
憙	喜
憚	惮
憝	譈 懟 𢥲
憤	愤
憩	憇
憫	愍 悯
憮	怃
憯	㦧
憰	譎
憲	宪
憶	忆
懁	悁
懃	勤
懇	恳
懈	𢢣
應	応 硬 应
懌	怿
懍	懔
懐	懷
懑	懣
懒	懶
懔	凛 懍
懜	懵
懞	蒙
懟	憝 譈 怼
懣	㥃 悶 懑
懥	懫
懨	恹
懫	懥 𡒐 𡏸
懮	憂
懲	惩
懴	懺
懵	懜
懶	懒
懷	怀 怌 褱
懸	悬
懺	懴 忏
懼	惧 愳 𢡔
懽	歡 欢
懾	慑
戀	戀 恋 𤕈
戆	戇
戇	戆
戉	鉞
戋	戔
戏	戲
成	𢦩
我	𠨂 𢦓 𢦠
戒	𢦬
戔	戋
或	𢈿
戗	戧
战	戰
戛	戞
戝	賊
戞	戛
戟	屰
戦	戰
戧	創 戗
戩	戬
戬	戩
戮	戮 𡠢 𦐱
戯	戲 戱
戰	戦 战
戱	戲 戯
戲	戯 戱 呼 戏
戴	𢨇
戶	戸 㦿 𣥘 户
户	戶
戸	戶
戹	厄
戻	戾
戼	卯
戾	戻 𤡵 盭
所	𢨷
扁	碥 𡲜 艑
扃	𢇺
扅	扊
扇	煽
扈	𡴱
扊	扅
手	扌 𠂿
扌	手
才	哉 纔 財
扎	紮
扏	㧨
扐	朸
扑	撲
払	拂
托	拓
扛	摃
扞	擀 捍
扠	搋
执	執
扩	擴
扪	捫
扫	掃
扬	揚
扯	撦
扰	擾
扱	插
扳	攀
扵	于 亏 於
扶	𢻳 𢱿
扺	抵
扻	損
扼	㧖 搤
抃	拚
抉	刔
抌	舀
抍	拯 基
投	𢫹
抗	亢
折	翼 拃
抚	撫
抛	拋
抜	拔
抝	拗
択	擇
抟	摶
抠	摳
抡	掄
抢	搶
护	護
报	報
披	翍 㓟
抬	擡
抱	抔
抵	扺 𠥯
抻	伸
抽	𢭆
抿	㨉
拂	払
拃	折
担	擔
拆	責
拇	𧿹
拈	敁
拉	拉
拊	撫
拋	抛
拏	拏 拿 挐
拓	拓 托 摕
拔	抜
拕	拖
拖	拕
拗	抝
拙	䂐
拚	抃 帆
拜	拝 𣬊 𣬓 𢰛 𢴽 𡴬
拝	拜
拟	擬
拡	擴
拢	攏
拣	揀
拥	擁
拦	攔
拧	擰
拨	撥
择	擇
拪	遷 迻
拭	𢂑
拯	抍 基
拳	𢮙 㩲
拴	揎
拼	摒 秉
拽	曳
拾	十
拿	拏 拏 挐
挂	掛
挅	挆
挆	挅
指	𢫾
按	搵
挐	拏 拿
挙	舉
挚	摯
挛	攣
挜	掗
挝	撾
挞	撻
挟	挾
挠	撓
挡	擋
挢	撟
挣	掙
挤	擠
挥	揮
挦	撏
挩	捝
挫	繲
挭	骾 鯁
挱	挲
挲	挱
挷	搒
挸	𢹕
挼	捼
挽	掇 輓
挾	挟
捆	綑
捉	杓
捊	㩠
捌	八
捍	扞
捏	揑
捓	揶
捜	搜
捝	挩
捞	撈
损	損
捡	撿
换	換
捣	搗
捦	擒
捨	舍
捫	扪
捬	撫
据	據
捲	卷
捴	總
捵	䥀
捶	搥 箠
捻	捻
捼	挼
掂	敁
掃	埽 扫
掄	抡
掇	挽
掉	棹
掌	𤓯
掏	搯
掐	𠜼
掗	挜
掘	撅
掙	挣
掛	挂
掠	掠
採	采
掩	揜 揞
掬	匊
掲	揭
掳	擄
掴	摑
掷	擲
掸	撣
掺	摻
掻	搔
掼	摜
掽	碰
揀	拣
揅	研
揎	拴
揑	捏
插	扱
揚	敭 𠭲 扬
換	换
揜	掩
揝	撍 攢
揞	掩
握	𦥆
揣	𢭍
揦	攋
揪	揫
揫	揪
揭	掲 結
揮	𢱳 挥
揯	搄
揶	捓
揷	插
揸	楂 摣
揺	搖
揽	攬
揾	搵
揿	撳
搀	攙
搁	擱
搂	摟
搃	總 摠
搅	攪
搆	構
搇	撳
搉	㩁
損	扻 损
搒	挷
搔	掻
搖	揺 摇
搗	擣 捣
搜	捜 𢯱 𢲷
搞	攪
搤	㧖 扼
搥	捶
搧	煽
搨	搭
搪	傏
搫	搬
搬	搫
搭	搨 撘
搯	掏
搵	按 揾
搶	抢
携	攜
摁	恩
摂	攝
摃	扛
摄	攝
摅	攄
摆	擺
摇	搖
摈	擯
摊	攤
摑	掴
摒	屏 拼
摔	甩
摕	拓
摜	掼
摟	搂
摠	搃 總
摡	溉
摣	揸
摩	𢳀
摭	拓
摮	𢳆
摯	挚
摳	抠
摴	舒
摶	抟
摻	掺
摼	牽
摽	𢹰
撂	㨼
撃	擊
撄	攖
撅	掘
撆	撇
撇	撆
撈	捞
撍	揝 攢
撏	挦
撐	撑
撑	撐
撓	挠
撘	搭
撚	撚
撝	㧑
撟	嬌 挢
撢	撣
撣	撢 掸
撥	拨
撦	扯
撫	拊 捬 𨑟 抚
播	𢿥 𨤏
撲	攴 扑
撳	搇 揿
撵	攆
撷	擷
撸	擼
撹	攪
撺	攛
撻	𨘈 𢽞 挞
撾	挝
撿	捡
擀	扞
擁	拥
擃	攮
擄	擄 虜 掳
擇	択 择
擊	撃 击
擋	攩 挡
擒	捦
擓	㧟
擔	担
擗	劈
據	拠 据
擞	擻
擠	挤
擡	抬
擣	搗
擥	㩜 攬
擧	舉
擬	儗 拟
擯	摈
擰	拧
擱	搁
擲	擿 掷
擴	扩
擷	撷
擸	㧜
擺	摆
擻	擞
擼	撸
擾	扰
擿	擲
攀	㐴 扳
攄	摅
攅	攢
攆	撵
攋	揦
攏	拢
攒	攢
攔	拦
攖	撄
攘	𣀮
攙	搀
攛	撺
攜	携
攝	摂 摄
攢	攅 揝 撍 攒
攣	挛
攤	摊
攩	擋
攪	搞 搅
攬	㩜 擥 揽
攮	擃
支	𠦙 𢺶
攴	撲 攵
攵	夊 攴
收	収 㧃
攷	考
放	匸
敁	掂 拈
敃	暋
效	効
敉	侎
敌	敵
敍	叙 敘
敎	教 𤕝 𧧿
敏	勄
敓	敚
敕	勅 勑
敗	贁 貝 𤖐 䢙 败
敘	敍 叙
教	敎
敚	敓
敛	斂
敠	敪
敢	𠭖 𢽤 𣪏
散	枚
敦	𢼪 𠧉 惇
敩	斅
敪	敠
敬	𣀖 𢿩
敭	揚
数	數
敲	䯨
敵	敌
敶	陳
敷	旉 尃
數	数
敺	驅
敻	夐
敽	敿
敿	敽
斁	𤢕
斂	敛
斃	毙
斄	𠩬
斅	斆
斆	斅 鏰
文	㒚 穩
斈	學
斉	齊
斋	齋 齊
斌	彬
斍	覺
斎	齋
斓	斕
斕	斓
斗	𣂑 鬥
斚	斝
斝	斚 檟
斞	㔱 庾
斤	觔
斥	㡿
斩	斬
斬	斩
断	斷
斮	𢧉
斯	𣂕
新	𢀝
斲	㓸 斵
斵	斲
斷	𣂢 𠜷 𠝅 断
方	𤙗
於	烏 𣱏 𤕘 于 亏 扵
施	𢒃 𠇜 𠤒
斾	旆
旁	𣃟 𣃙 㝑 傍
旂	旗
旅	旅 𣥏 𣃨 魯 𣥐
旆	斾
旈	旒
旉	敷 尃
族	㞺 𥎩 𥎼 𥏁
旒	旈
旗	旂
旘	幟
旛	幡
无	𠑶 無
旡	𠘸
既	旣
旤	禍
日	𡆸
旦	蛋
旧	舊
旨	𠮛 𤮻 𣅌 𠩊
旪	協
旬	𠣙 𠣡
旭	旯
旮	旭
旯	旭
时	時 旹
旷	曠
旸	暘
旹	时 時
旾	春
昂	昻
昇	升
昉	昞
明	朙
昏	𣄾 𣄼 昬
昒	㫚
易	易
昙	曇
昚	愼
昜	陽
昝	偺 喒
昞	昉
星	𠻖 曐 𤽛 皨
映	暎
春	萅 𦸬 旾 𣈤
昧	𣆜
昪	忭
昬	昏
是	昰 𣆞
昰	是 夏
昵	暱
昶	暢
昷	𥁕
昻	昂
昼	晝
昽	曨
显	顯
昿	曠
晁	朝
時	旹 时
晃	晄
晄	晃
晅	烜
晉	晋 𣈆
晋	晉
晒	曬
晓	曉
晔	曄
晕	暈
晖	暉
晚	晩 𣆛
晝	昼
晢	晰
晤	𣅎
晨	𠔹
晩	晚
晰	晢 晳
晳	晰
晴	晴
智	𥏼
暁	曉
暂	暫
暈	晕
暉	晖
暋	忞 敃
暎	映
暖	煖 娠
暗	晻
暘	旸
暠	皜 𣉞
暢	畅
暣	𣅠
暦	曆
暧	曖
暨	曁
暫	暂
暱	昵
暴	暴 𣋴 虣
暸	瞭
曁	屆 𦤌 𠕨
曄	曅 晔
曅	曄
曆	𢍷 厤 歴 歷 历
曇	昙
曉	暁 晓
曏	向
曐	星
曖	瞹 暧
曜	𣇪 𤒂 燿 耀
曠	昿 𣊥 旷
曡	疊 叠
曨	昽
曬	晒
曳	曵 拽
更	更 㪅
曵	曳
書	书
曹	曺
曼	㬅
曽	曾
曾	曽
最	𣤜
朁	參 㬱
朂	勗
會	𣌭 㞧 𠃐 㣛 𣥈 会
有	
朌	頒
服	𣍞 𦨈
朏	𣍧
朐	胊 鸜 鴝
朔	𣍮
朕	𦩎
朖	朗
朗	朗 𥇑 脼
朙	明
望	朢 𦣠
朝	晁
朞	期 稘 𣍡 𥟝 𣇳
期	朞 𣅆 𠔸 逞
朢	望
朦	蒙 矇
朧	矓 胧
朩	等
本	夲 楍 㮺 𡴡
札	箚
术	術
朳	杷
朴	樸
朵	朶 㙐
朶	朵
朸	扐
朹	簋
机	機
朿	莿
杀	殺
杂	雜
权	權
杆	桿
杇	圬
杍	李
李	李 杍
村	邨
杓	捉
杝	柂
杠	槓
条	條
来	來
杧	芒
杨	楊
杩	榪
杯	盃 𠤯
杰	傑
東	东
杴	𣞘 锨
杷	朳
杸	殳
松	枩 㮤 梥 庺 鬆
板	版 闆
枀	松
极	極 极
构	構
枉	𣒈
枏	楠
析	𣂔
林	林
枚	散
果	菓
枞	樅
枢	樞
枣	棗
枥	櫪
枧	梘
枨	棖
枩	松
枪	槍
枫	楓
枬	楠
枭	梟
枱	儓 檯
枴	拐
架	榢
枾	柿 柹
柁	舵
柂	杝
柄	棅
柆	拉
柏	栢 孛
某	梅 厶
柒	漆 七
柙	㘡
柚	櫾
柜	櫃
柠	檸
查	査
柩	柾
柬	𥳑
柰	奈
柳	檉 丣 𣓠
柴	茈
柵	栅
柹	枾
査	查
柽	檉
柾	柩
柿	枾
栀	梔
栄	榮
栅	柵
标	檁 標
栈	棧
栉	櫛
栊	櫳
栋	棟
栌	櫨
栎	櫟
栏	欄
树	樹
栒	簨
栖	棲
栗	慄 㮚 𣡼 𣡷 慄
栛	荔
栝	檜
校	𨬛 𤲽
栢	柏 孛
栰	筏
样	樣
核	覈 𣝗
栾	欒
桀	㘶
桁	航
桌	棹
桑	桒 𣕐 𠭌
桒	桑
桜	櫻
桟	棧
桠	椏
桡	橈
桢	楨
档	檔
桤	榿
桥	橋
桦	樺
桧	檜
桨	槳
桩	樁
桪	樳
桮	杯
桼	𢒡 㯃 漆
桿	杆
梁	梁 𣹷 渿 樑
梅	楳 某 槑
梔	栀
梘	枧
條	条 糶
梟	鴞 枭
梥	松
梦	夢
梨	梨 棃
梲	棳 棁
梹	檳
梼	檮
梾	棶
梿	槤
检	檢
棁	梲
棂	欞
棃	梨
棄	弃 𢍞 𨓋
棅	柄
棊	棋 碁
棋	棊 碁
棐	榧
棑	篺
棕	㯶 椶
棖	枨
棗	𠂲 枣
棟	栋
棥	樊
棧	桟 栈
棰	槌
棱	稜 楞
棲	栖
棳	梲
棶	梾
棹	桌 櫂 卓
棺	𣑄
椀	盌 碗
椁	槨
椎	槌
椏	桠
椒	茭
椘	楚
検	檢
椝	槼
椟	櫝
椠	槧
椤	欏
椫	樿
椭	橢
椰	㭨
椶	棕
椹	葚
椾	牋
楂	查 揸 槎
楊	杨
楍	本
楓	枫
楕	橢
楙	茂
楚	椘 𣕪
楜	胡
楞	稜 棱
楠	枏 枬
楡	榆
楥	楦
楦	楥
楨	桢
楫	艥 檝
業	𤑽 𤎸 业
楳	梅
極	极
楷	𣗀
楼	樓
楽	樂
概	槪 槩
榄	欖
榅	榲
榆	楡
榇	櫬
榈	櫚
榉	櫸
榎	檟
榘	矩
榛	亲
榢	架
榦	乾
榧	棐
榨	醡 酢
榪	杩
榮	荣
榲	榅
榴	橊
榿	桤
槀	稿
槅	核
槇	槙
槊	鎙
構	构
槌	棰 椎
槍	枪
槎	楂
槏	廉
槑	梅
槓	杠 篢
槖	橐
様	樣
槙	槇
槚	檟
槛	檻
槜	檇
槟	檳
槠	櫧
槤	梿
槧	椠
槨	椁
槩	㮣 概
槪	㮣
槳	桨
槹	𣓌
槻	規
槼	椝
樁	桩
樂	樂 乐
樅	枞
樊	棥
樐	櫓 㯭 艪
樑	梁
樓	樓 楼
標	标
樚	轆
樞	枢
樣	様 样
権	權
横	橫
樯	檣
樱	櫻
樳	桪
樷	叢
樸	朴
樹	𡬾 𣕒 𣚤 树
樺	桦
樻	匱 櫃
樽	罇 墫
樿	椫
橆	無
橇	鞒 鞽
橈	桡
橊	榴
橋	桥
橐	𡇈 槖
橓	蕣
橛	橜
橜	橛
機	机
橢	楕 椭
橥	櫫
橦	幢
橫	横
橱	櫥
橹	櫓
橼	櫞
檁	标 檩
檇	槜
檉	柳 柽
檐	簷
檒	風
檔	欓 档
檘	蘗
檛	簻
檜	栝 桧
檝	楫 艥
檟	榎 斝 槚
檠	𢐧
檢	検 检
檣	艢 樯
檩	檁
檮	梼
檯	儓 枱 台
檳	梹 㯽 槟
檴	穫
檸	柠
檻	槛
檼	櫽
檾	䔛
櫂	棹 掉
櫃	匱 柜 樻 饋 鐀
櫈	凳
櫉	櫥
櫌	耰
櫓	櫓 㯭 樐 艪 橹
櫚	榈
櫛	栉
櫝	匵 椟
櫞	橼
櫟	栎
櫥	櫉 橱
櫧	槠
櫨	栌
櫪	枥
櫫	橥
櫬	榇
櫱	𣎴 蘖
櫳	㰍 栊
櫸	榉
櫺	欞
櫻	樱
櫽	檼
櫾	柚
欄	欄 栏
權	権 权
欏	椤
欒	灤 栾
欓	檔
欖	榄
欝	鬱
欞	櫺 棂
欠	缺 𣣓
次	𦮏 𠕞 𠤣
欢	懽 歡
欣	忻
欤	歟
欧	歐
欬	咳
欲	慾
欵	款
欶	𠲿
欸	唉
欹	猗
欼	啜 歠
欽	𣣽 钦
款	欵
歈	𣤏
歉	欠
歌	可 哥 謌
歎	嘆
歐	欧
歓	歡
歕	呠 噴
歖	喜
歗	嘯
歛	斂
歟	欤
歠	啜 欼
歡	驩 𧆒 懽 欢
止	只
正	㱏 𣥔 𤴓 𧾸
歧	岐 𨙸
歩	步
歬	前
歯	齒
歱	踵
歲	亗 𡻕 𢧁 岁 嵗 歳
歳	歲
歴	歷 曆
歷	曆 歴 𡿌 历
歸	帰 归 𤾤
歹	歺 𡰮
歺	歹
死	𠑾 𣥴
歼	殲
歾	沒
歿	殁 沒
殀	夭
殁	歿
殂	𡲂 𣨐 𣧫 𡲡 𣨖
殃	䄃 𥙏
殄	𣦺 𠂈
殇	殤
殉	侚 狥
残	殘
殍	莩
殒	隕 殞
殓	殮
殘	残
殚	殫
殞	隕 殒
殡	殯
殤	殇
殨	㱮
殪	𣨑 𣩉
殫	殚
殮	殓
殯	殡
殰	𦢌 㱩
殱	殲
殲	𣨦 歼
殳	杸
殴	毆
段	𠩻
殸	聲
殺	殺 𢁛 𢽅 𢿹 𢽆 𢼡 𢿔 𧤿 杀
殻	殼 壳
殼	㱿 壳 殻
殽	淆
毀	𣪷 毁
毁	毀
毂	轂
毆	殴
毎	每
每	毎
毐	娭
毑	姐
毒	𦸕 𧉉
毓	育
比	夶 𣬅
毕	畢
毗	毘
毘	毗
毙	斃
毡	氈
毧	㲓
毫	𡨉
毬	球
毵	毿
毿	毵
氂	犛 牦
氅	鷩
氇	氌
氈	毡 氊
氊	氈
氌	氇
氏	厥
氐	𢎮
民	𠘽
氒	厥
氓	甿
气	氣
気	氣
氜	陽 阳
氢	氫
氣	気 炁 𣱛 气
氤	絪
氩	氬
氫	氢
氬	氩
氯	綠
氲	氳
氳	氲
水	氵
氵	水
氷	冰 冫
氼	溺
氽	尿
氾	泛
求	裘
汇	彙 匯
汉	漢
汎	泛
汏	𡊌
汓	遊 游
汙	汚 污 洿
汚	汙 洿
污	汙
汤	湯
汨	淿 汩
汩	汨
汬	阱
汶	渂
汹	洶
決	决
沅	源
沇	沿
沈	沉 瀋
沉	瀋 沈
沍	冱
沒	歿 歾 𣇶 没
沖	盅 冲
沜	泮
沟	溝
没	沒
沢	澤
沣	灃
沤	漚
沥	瀝
沦	淪
沧	滄
沨	渢
沩	溈 潙
沪	冱 滬
沬	湏
沱	沲
沲	沱
沵	濔
沸	㵒
治	乿
沽	夃
沿	沇
況	况 𡶢
泄	洩 渫
泉	洤
泊	泺
法	佱 灋 𣳴
泖	茅
泙	洴
泛	汎
泝	溯 遡
泞	濘
泡	箔
泥	泥 坭
注	註
泪	淚
泮	沜
泰	夳
泲	濟
泶	澩
泷	瀧
泸	瀘
泺	濼
泻	瀉
泼	潑
泽	澤
泾	涇
洁	潔
洌	冽
洒	灑
洓	漬
洚	洪
洛	洛 洜
洜	洛
洞	峒
洟	涕 𪖦
洤	泉
津	𦪉 𦩏 𣸁 𦩦 𦩨 𨔥
洩	泄 渫
洪	洚
洴	泙
洶	汹
洼	窪
洿	汙 汚
流	流 㳅
浃	浹
浄	淨
浅	淺
浆	漿
浇	澆
浈	湞
浉	溮
浊	濁
测	測
浍	澮
济	濟
浏	瀏
浐	滻
浑	渾
浒	滸
浓	濃
浔	潯
浚	濬
浜	濱
浣	澣
浧	澄
浩	澔
浪	浪
浸	𥧲
浹	浃
浼	凂
涂	塗
涇	泾
消	㴅
涉	渉 𣥿 㴇
涌	湧
涎	㳄
涕	洟 䶏
涖	莅 蒞
涙	淚
涚	涗
涛	濤
涜	瀆
涝	澇
涞	淶
涟	漣
涠	潿
涡	渦
涢	溳
涣	渙
涤	滌
润	潤
涧	澗
涨	漲
涩	澀
涶	唾
涸	凅
涼	凉 凉
淀	澱
淆	殽
淋	淋
淒	凄
淚	淚 泪
淜	漰 馮
淡	澹
淥	渌
淨	凈
淪	沦
淫	婬 㸒
深	𣸧
淳	湻 𤂸
淵	𣶒 囦 𠝃 渊
淶	涞
淸	清 𠗜
淹	渰
淺	浅
淾	飮
淿	汨
渂	汶
清	淸
渇	渴
済	濟
渉	涉
渊	淵
渋	澀
渌	淥
渍	漬
渎	瀆
渐	漸
渑	澠
渓	溪
渔	漁
渕	淵
渖	瀋
渗	滲
渙	涣
渚	陼
減	减
渜	湪
渢	沨
渦	涡
渨	隈 偎
温	溫
渫	泄 洩
測	测
渰	淹
渴	渇 𣊅
游	逰 汓
渹	𢕐 訇
渾	浑
渿	梁
湊	凑
湏	須 沬
湑	醑
湛	㴴
湞	浈
湟	況
湧	涌
湪	渜
湯	汤
湻	淳
湾	灣
湿	溼 濕
満	滿
溁	濚
溃	潰
溅	濺
溆	漵
溇	漊
溈	潙 沩
溉	漑 摡
溌	潑
源	厵
準	凖 准
溜	溜
溝	沟
溞	叜
溪	渓
溫	温
溮	浉
溯	泝 遡 㴑
溳	涢
溺	尿 氼 㲻
溻	褟
溼	濕
溽	縟
滄	𣶟 𣳁 沧
滅	烕 𣹹 𢦹 灭
滋	𣳯 𦱳
滌	涤
滎	荥
滑	磆
滗	潷
滙	匯
滚	滾
滞	滯
滟	灔 灧
滠	灄
满	滿
滢	瀅
滤	濾
滥	濫
滦	灤
滨	濱
滩	灘
滪	澦
滬	沪
滯	滞
滲	渗
滷	卤
滸	浒
滺	悠
滻	浐
滾	菌 滚
滿	𡈪 满
漁	䱷 渔
漆	柒 㯃 桼 𣴶
漇	𢳜
漊	溇
漎	潨
漏	漏
漑	溉
漓	灕
漚	沤
漢	㵄 𣶔 汉
漣	涟
漤	灠
漧	乾
漫	澷
漬	洓 渍
漰	淜
漱	潄
漲	涨
漵	溆
漸	渐
漾	瀁
漿	𤕯 浆
潀	潨
潁	颍
潅	灌
潆	瀠
潇	瀟
潋	瀲
潍	濰
潑	溌 泼
潔	洁
潙	溈 沩
潛	潜
潜	潛
潝	㴔
潤	润
潦	澇
潨	潀 漎
潬	灘
潯	浔
潰	溃
潴	瀦
潷	滗
潸	𣽽
潿	涠
澀	澁 濇 瀒 涩
澁	澀 濇
澄	澂 浧
澆	浇
澇	潦 涝
澈	徹
澑	溜
澔	浩
澗	磵 涧
澙	潟
澛	瀂
澜	瀾
澠	渑
澣	浣
澤	沢 㚖 泽
澦	滪
澩	泶
澮	巜 𣴯 𣲸 浍
澱	淀
澳	襖 𥜌
澷	漫
澹	淡
濁	浊
濃	浓
濇	澀 澁 瀒
濑	瀨
濒	瀕
濔	沵
濕	𦒣 溼 湿
濘	泞
濚	溁
濛	霥 靀
濜	浕
濟	泲 㴉 济
濤	涛
濫	滥
濬	浚 𣽊 䜭
濰	潍
濱	濵 瀕 𣴩 𩔤 𨽗 滨
濳	潛
濵	濱 瀕
濶	闊
濺	溅
濼	泊 泺
濾	濾 滤
濿	砅
瀁	漾
瀂	澛
瀅	滢
瀆	渎
瀇	㲿
瀉	泻
瀋	沈 渖
瀏	浏
瀒	澀 濇
瀕	濱 濵 濒
瀘	泸
瀝	沥
瀟	潇
瀠	潆
瀦	潴
瀧	泷
瀨	瀬 濑
瀬	瀨
瀰	彌
瀲	潋
瀾	澜
灃	沣
灄	滠
灋	法
灌	潅
灎	灔
灏	灝
灑	𣶇 洒
灔	灩
灕	漓
灘	潬 滩
灝	灏
灠	漤
灣	湾
灤	滦
灧	灔 滟
火	𤆄 灬
灬	火
灭	滅
灮	光
灯	燈
灰	灰
灴	烘
灵	靈
灶	竈
灹	燠
災	烖 𤆎 𦸜 灾 菑
灾	災 菑 烖
灿	燦
炀	煬
炁	氣
炅	耿
炉	爐
炔	耿
炖	燉
炗	光
炙	炙
炜	煒
炝	熗
炤	照
炫	衒
炮	砲 炰 礮
炯	烱
炰	炮
炸	煠
点	點
為	爲 为
炼	煉
炽	熾
烁	爍
烂	爛
烃	烴
烈	煭
烉	煥
烊	煬
烏	𤚶 於 𥾪 乌
烕	滅
烖	災 灾 菑
烘	灴
烙	烙
烛	燭
烜	晅
烝	蒸
烟	完 菸 煙
烦	煩
烧	燒
烨	燁
烩	燴
烫	燙
烬	燼
热	熱
烱	炯
烴	烃
烹	亯 𠅖 𩱋
烾	赤
焈	煕
焔	焰
焕	煥
焖	燜
焘	燾
焚	燔
無	𣟒 𣚨 𠘩 无 橆
焦	焳
焭	煢
焰	焔 燄
然	𤓉
焼	燒
煅	鍛
煆	鍜
煇	輝
煉	煉 炼
煑	煮
煒	炜
煕	熙 焈
煖	暖 娠
煙	𡨾 𠖜 𡍯 完 烟 菸
煚	煛
煛	煚
煠	炸
煢	㒌 茕
煥	烉 焕
照	炤
煩	烦
煬	烊 炀
煭	烈
煮	煑
煱	㶽
煳	㷻
煴	熅
煽	搧
熅	煴
熇	燺
熈	熙
熊	𪏛
熏	燻 𤑕
熒	荧
熔	鎔
熗	炝
熙	煕 熈
熟	𡒒
熨	㷉 尉
熱	𤍠 热
熲	耿 颎
熹	熺
熺	熹
熾	𧹹 𤎷 炽
燁	烨
燄	焰
燈	灯
燉	炖
燎	燎
燐	燐 㷠 粦
燒	簫 烧
燔	焚
燕	鷰
燗	爛
燙	烫
燜	焖
營	营
燠	灹 𤈰
燣	燷
燦	灿
燧	𤑾 𤓫
燭	烛
燴	烩
燶	㶶
燷	燣
燺	熇
燻	熏
燼	烬
燾	焘
燿	曜 耀
爋	𤑕
爍	烁
爐	爐 炉
爛	烂
爨	𤑖
爪	㕚 爫
爫	㕚 爪
爭	争 𠫩 𠄙
爯	𤔹
爱	愛
爲	為 𦥮 𤓸 为
爵	𥥼 𩰧 𣡫 𠙘
爷	爺
爺	𤕓 爷
爼	俎
爽	𠙠
爾	尒 尔
爿	𤕪
牀	床
牄	蹌
牆	墻 廧 𤖧 墙
版	板
牋	箋 椾
牍	牘
牕	窻 窗 窓
牘	牍
牙	𤘈
牛	牜
牜	牛
牝	𠤎
牟	麰 𢃷
牠	它 他
牢	牢 𡘠
牦	犛 氂
牴	觝 牴
牵	牽
牺	犧
牽	摼 𢴡 牵
犁	犂
犂	犁
犄	踦
犇	奔
犊	犢
犖	荦
犛	髦
犠	犧
犢	犊
犧	牺
犬	犭
犭	犬
犯	𤝑 𢒿
犲	豺
犴	豻
状	狀
犷	獷
犸	獁
犹	猶
狀	状
狂	𢚇
狈	狽
狝	獮
狞	獰
狢	貉
狥	侚 殉
独	獨
狭	狹
狮	獅
狯	獪
狰	猙
狱	獄
狲	猻
狵	尨
狷	獧
狸	貍
狹	陜 狭
狻	䝜
狼	狼
狽	狈
猃	獫
猇	唬 虓
猋	飇 颮
猎	獵
猕	獼
猗	欹
猘	𤝼
猙	狰
猛	𠩜
猟	獵
猡	玀
猨	蝯 猿
猪	猪 豬
猫	貓
猬	蝟
献	獻
猶	犹
猻	狲
猾	獪
猿	猨 蝯
獁	犸
獃	呆
獄	𡈭 狱
獅	狮
獎	奬 奖
獐	麞
獠	䝤
獣	獸
獧	狷
獨	独
獪	猾 狯
獫	玁 猃
獭	獺
獮	狝
獰	狞
獱	㺍
獲	获
獵	獵 𤢪 猎
獷	犷
獸	兽
獺	獭
獻	献
獼	猕
獾	貛
玀	猡
玁	獫
玄	伭
玅	妙
玆	茲 兹 𢆶
率	率 卛
玉	𤣪
玑	璣
玕	𤥚
玖	九
玙	璵
玚	瑒
玛	瑪
玟	珉 玫
玪	琳
玫	玟
玮	瑋
环	環
现	現
玱	瑲
玲	玲
玳	瑇
玺	璽
珉	玟 䃉 砇
珌	㻫
珍	珎 錱
珎	珍
珐	琺
珑	瓏
珒	𤦯
珞	珞
珡	琴
珤	寶
珪	圭
班	𤼬
珰	璫
珲	琿
珶	瑅
珷	碔
現	现
琄	鞙
琅	瑯 𤨜 𤦴
理	理
琉	琉 瑠
琎	璡
琏	璉
琐	瑣
琱	雕
琳	玪
琴	𨪖 𨫹 𤫍 珡 𩰔
琺	珐
琼	瓊
琿	𤦳 珲
瑁	㺺 𤣽
瑅	珶
瑇	玳
瑋	玮
瑒	玚
瑙	碯
瑟	㻎 𡘼 𡚉 𩇰
瑠	琉
瑣	琐
瑤	瑶
瑩	瑩 莹
瑪	玛
瑯	琅
瑲	玱
瑶	瑤
瑷	璦
瑸	璸
瑽	璁
璁	瑽
璃	瓈
璇	璿
璉	琏
璎	瓔
璘	璘
璡	琎
璢	琉
璣	玑
璦	瑷
璫	珰
環	环
璵	玙
璸	瑸
璹	𠩱
璽	壐 玺
璿	𤩅 𤩋 璇
瓈	璃
瓊	琼
瓏	珑
瓒	瓚
瓔	璎
瓚	瓒
瓟	匏
瓢	𤬣
瓮	罋 甕
瓯	甌
瓶	缾
瓷	甆 磁
甁	瓶
甃	㼙
甆	瓷
甌	瓯
甎	磚
甕	瓮 罋
甖	罌 罃
甘	𠙸 𠙿
甚	什 𠯕 𥱅
甛	餂
甜	甛
甞	嘗
生	𤯓
產	产
産	產 产
甤	蕤
甦	穌
用	𤰆 𠛁
甩	摔
甪	角
甬	埇
甯	寗
甲	𠇚 𡴌
申	𤰶 𠭙
电	電
町	圢
画	畫
甽	畎
甾	菑
甿	氓
畀	畁
畁	畀
畂	㙀
畄	留 畱
畅	暢
畆	畝
畊	耕
界	畍
畍	界
畎	甽
畏	𤰲 𤰣
畒	畝
畗	答 福
留	畄 畱
畛	𤱥
畜	嘼
畝	畮 𤱑 畆 亩
畢	毕
畣	答
略	畧
畧	略
番	蹯 𥸨 𥻫
畫	画 𤱪 𨽶 𤲯 畵 划
畬	畭 𤰩
畭	畬
畮	畝
異	異 𢄖 异
畱	畄 留
畲	畬
畳	疊
畴	疇
畵	畫
當	𤱭 当
畺	疆 將
畽	疃
疃	畽
疆	畺 將
疇	𢑔 𠾉 畴
疉	疊
疊	曡 叠
疋	匹 足
疍	蛋
疎	疏
疏	疎
疑	𦬦
疖	癤
疗	療
疟	瘧
疠	癘
疡	瘍
疣	肬
疬	癧
疭	瘲
疮	瘡
疯	瘋
疱	皰
疴	痾
疸	癉
疹	胗
疾	𤕼 𤖏 𥏂 𠥻 𤶅
症	癥
痈	癰
痉	痙
痐	蚘
痒	癢
痖	瘂
痙	痉
痢	痢
痨	癆
痩	瘦
痪	瘓
痫	癇
痮	脹
痲	痳
痳	痲
痴	癡
痹	痺
痺	痹
痼	㽽
痾	疴
瘂	啞 痖
瘅	癉
瘆	瘮
瘉	癒 愈
瘋	疯
瘍	疡
瘓	痪
瘖	陰
瘗	瘞
瘘	瘺 瘻
瘞	𨻏 瘗
瘠	㾊
瘡	創 疮
瘦	痩
瘧	弄 疟
瘨	癲
瘪	癟
瘫	癱
瘭	𤼄
瘮	瘆
瘲	疭
瘶	嗽
瘺	瘻 瘘
瘻	瘺 瘘
瘽	勤
瘾	癮
瘿	癭
療	疗
癅	𥏵
癆	痨
癇	痫
癉	疸 瘅
癊	𤷜
癒	愈 瘉
癘	疠
癛	癝
癞	癩
癟	瘪
癠	𤸾
癡	痴
癢	痒
癣	癬
癤	疖
癥	症
癧	疬
癨	霍
癩	癩 癞
癫	癲
癬	癣
癭	瘿
癮	瘾
癯	臞
癰	痈
癱	瘫
癲	瘨 癫
癸	𤼩
発	發
登	𤼪 𤼷 豋
發	発 发
白	𦣺 𤼽
百	佰 𦣻
皁	皂
皂	皁
皃	貎 貌
皇	𦤍 𦤐 𤽙 𤽚 𤽧
皈	歸
皋	皐 臯 睾
皍	卽
皎	㿟 皦
皐	皋
皑	皚
皓	顥 皝
皚	皑
皜	暠
皝	皓 顥
皞	皡 皥
皡	皞 皥
皥	皞 皡
皦	㿟 皎
皨	星
皮	𥬖 𠰎
皰	疱
皱	皺
皲	皸
皷	鼓 鼔
皸	皲
皺	縐 皱
皼	鼓
盃	杯
盅	沖
盇	盍
益	益 𠍳
盌	椀 碗
盍	盇
盏	盞
盐	鹽
监	監
盖	蓋 葢
盗	盜
盘	盤
盙	簠
盜	𠪁 𠉭 𤋆 𨹇 盗
盞	盏
盟	𢄾
盡	尽
監	𧨭 𧩾 譼 监
盤	鎜 盘
盧	卢
盩	盭
盪	蕩 蘯 逿 𨌩 荡
盭	盩 戾
目	𡇡 𥃦 𥆤
直	𣓟 𣖴
省	省 𡮀 䁞
眇	緲
眈	躭
眉	𥅮
眍	瞘
眎	視
眒	𥋀
眘	愼
眙	瞪
眞	真 𡙊
真	眞
眠	𥺠 緡
眡	視
眣	𥄺 𥉈
眥	眦
眦	眥
眬	矓
眱	𥄿 𥅣
眼	𥃩
眾	衆 𠂝 𥅫 𠱧 众
着	著
睁	睜
睏	困
睐	睞
睑	瞼
睜	睁
睞	睐
睦	𡻲
睪	𥇝
睫	䀹
睹	覩
睾	皋
睿	叡
瞅	矁
瞆	瞶
瞍	𥈟
瞒	瞞
瞘	眍
瞜	䁖
瞞	瞒
瞠	瞪
瞥	苤
瞩	矚
瞪	眙 瞠
瞬	䀢
瞭	了
瞯	瞷
瞰	矙
瞶	瞆
瞷	瞯
瞹	曖
瞼	睑
瞿	䀠
矁	瞅
矇	蒙 朦
矈	矏
矋	矖
矏	矈
矓	朧 眬
矖	矋
矙	瞰
矚	瞩
矛	𨥨 𢦧 鉾 𥍥
矢	笶 𠂕 𠓡
矣	𠤘
知	𢇻 𥎿
矧	訠
矩	榘
矫	矯
矮	躷
矯	矫
矰	蹭
石	𥐘
矶	磯
矾	礬
矿	礦
砀	碭
码	碼
砅	濿
砇	珉
砌	纖
砒	磇
研	硎 揅
砕	碎
砖	磚
砗	硨
砚	硯
砜	碸
砠	岨
砣	𥓿 鉈
砥	厎
砦	寨
砧	碪
砮	𠪓 𠩨
砰	𨺀
砲	炮 礮
破	𡲠
砺	礪
砻	礱
砾	礫
砿	礦
础	礎
硁	硜
硎	研
硕	碩
硖	硤
硗	磽
硙	磑
硚	礄
硜	䃘 踁 磬 硁
硤	唊 硖
硨	砗
硫	硫
硬	峺 應
硭	𥐞
确	確
硯	砚
硵	磠
硷	鹼 礆
碁	棊 棋
碌	碌
碍	㝵 礙
碎	砕
碔	珷
碕	崎
碗	椀 盌
碛	磧
碜	磣
碥	扁
碩	硕
碪	砧
碭	砀
碯	瑙
碰	掽
碱	鹼 鹻
碸	砜
確	确
碼	码
磁	瓷
磆	滑
磇	砒
磊	磊 磥
磌	𧰊
磏	廉
磑	硙
磒	隕
磚	甎 砖
磛	嶃
磡	墈
磣	碜
磥	磊
磧	碛
磪	崔
磬	硜 𡔝 𥓕
磯	矶
磴	嶝
磵	澗
磺	卝
磻	磻
磽	墝 硗
礄	硚
礆	險 硷
礎	础
礙	㝵 碍
礟	礮
礡	礴
礦	鑛 矿
礪	礪 砺
礫	砾
礬	矾
礮	炮 砲 礟
礱	𤮨 砻
礴	礡
礶	罐
示	𥘅 礻
礻	示
礼	礼 禮
社	𥙲 䄕 𥙭
礿	禴
祀	𥛴
祃	禡
祇	只
祎	禕
祐	𨳾 佑
祕	秘
祖	𥘲
祗	只 祬
祘	算
祝	𥘱
神	神 𥛠
祡	𥚨
祢	禰
祥	祥
祧	𥜔
祬	祗
祯	禎
祷	禱
祸	禍
祺	𥘕
祼	𥚌
祿	祿 禄
禀	稟
禂	禱
禄	祿
禅	禪
禋	𥛡 𠖦
禍	旤 𥚍 𣨷 𥙯 祸
禎	祯
福	福 畗
禕	祎
禡	𢒴 祃
禥	祺
禦	御
禪	禅
禮	禮 礼 𠃞 𤔑 礼
禰	祢
禱	𥛈 𥛇 禂 祷
禴	礿
禹	𢁰 𥜼
离	𡴥 離
禽	𢄕
禿	秃
私	厶
秃	禿
秄	耔
秆	稈
秇	埶 蓺 藝
秈	籼
秉	拼
秊	秊
秋	𪚼 龝 𪔁 䆋 秌 𥤛
秌	秋
种	種
秏	耗
秐	耘
秔	粳 稉
秕	粃
秗	飫
秘	祕
秤	稱
秦	𣜈
秩	豑
积	積
称	稱
秸	稭
移	迻
秽	穢
秾	穠
稀	希
稅	税
稆	穭
稈	秆
稉	秔 粳
稊	䄺
税	稅
稏	䅉
稕	𥤁
稘	朞
稚	穉 䕌 稺
稜	稜 棱 楞
稟	廪 禀
稣	穌
稬	糯
稭	秸
種	𥢖 𥡰 种
稱	偁 穪 秤 称
稲	稻
稳	穩
稷	𥞷
稺	稚
稻	稲
稽	乩 𩠜
稾	稿
稿	稾 槀
穀	糓 谷
穂	穗
穅	糠 𥹺
穆	𢿬 𢿉 𢾓 𥟙
穉	稚
穌	甦 稣
積	积
穎	頴 署 颖
穐	秋
穑	穡
穗	穂 𦼯
穞	穭
穠	秾
穡	穑
穢	𢧹 秽
穣	穰
穤	糯
穩	㒚 文 稳
穪	偁 稱
穫	檴 获
穭	穞 稆
穰	穣
穴	𥤢
究	𡫄
穷	窮
穹	𠫙
穻	宇
穽	阱
突	𡦾
窃	竊
窌	窖
窍	竅
窎	窵
窑	窯
窓	䆫 牕 窗 窻
窕	阿
窖	窌
窗	窓 𡆧 䆫 牕 窻
窜	竄
窝	窩
窥	窺
窦	竇
窩	窝
窪	洼
窭	窶
窮	竆 穷
窯	窰 窑
窰	窯
窴	塡
窵	窎
窶	寠 窭
窺	窥
窻	牕 窓 窗
竃	灶
竄	𥨒 窜
竅	窍
竆	窮
竇	窦
竈	灶
竉	䆔 𥥅
竊	𢿝 窃
立	立
竒	奇
竖	豎 竪
竚	佇
竜	龍
竝	並 并 幷
竞	競
竢	俟
竦	𢷜 𢖗
竩	𧧼
竪	豎 竖
端	耑
競	竸 誩 竞
竸	競
竻	筋 簕 𥵚
竾	篪
竿	𣔼
笃	篤
笄	𠚙
笆	巴
笋	筍
笑	咲 𠇄
笓	篦
笔	筆
笕	筧
笛	篴
笠	笠
笨	㤒
笺	箋
笻	筇
笼	籠
笾	籩
筆	笔
筇	笻
等	朩
筋	觔 竻
筍	𥳦 𥰴 笋
筏	栰
筐	筺
筑	築
答	荅 畣 畗
策	筞
筚	篳
筛	篩
筜	簹
筝	箏
筞	策
筦	管
筧	笕
筭	算
筯	箸
筱	篠
筴	䇲
筹	籌
筼	篔
签	籤 簽
筿	篠
简	簡
箇	個 个
箋	牋 笺
箍	箛
箎	篪
箏	筝
箒	帚
箓	籙
箔	泡
箕	𠀠 𠴩 䇧 𦋊 𥫶 𠷛 𠔋 𥫚 𠔛 𡿸
箖	籃
算	祘 筭
箘	箟
箚	剳
箛	箍
箝	钳
箟	箘
箠	捶
管	筦
箦	簀
箧	篋
箨	籜
箩	籮
箪	簞
箫	簫
箬	篛
箭	𥳭
箳	簈
箴	針 鍼
箸	筯 𣥧
箾	簫
節	罇 卩 节
範	范
築	筑
篋	匧 箧
篑	簣
篓	簍
篔	筼
篛	箬
篠	筿 筱
篡	簒
篢	槓
篤	笃
篦	笓
篩	簛 簁 筛
篪	竾 箎
篭	籠
篮	籃
篯	籛
篱	籬
篲	彗 𥱵
篳	筚
篴	笛
篺	棑
簀	箦
簁	篩 簛
簈	箳
簋	㔲 朹
簍	篓
簑	蓑
簒	篡
簔	簑
簕	竻
簖	籪
簘	簫
簛	篩 簁
簞	箪
簠	盙 𠤱 𦻌
簡	耕 简
簣	蕢 籄 篑
簨	栒
簪	兂 𥯓
簫	燒 箾 𪛕 箫
簬	簵
簵	簬
簷	檐
簹	筜
簻	檛
簽	签
簾	簾 𢅖 𢅏 帘
籁	籟
籃	箖 𢉧 篮
籄	簣 蕢
籌	筹
籐	籘 藤
籑	䉵 饌
籔	藪
籖	籤
籘	籐
籙	箓
籜	箨
籟	籁
籠	籠 笼
籤	籖
籥	龠
籩	笾
籪	簖
籬	篱
籮	箩
籲	龥
籴	糴
籵	蹯
类	類
籼	秈
粃	秕
粋	粹
粒	粒 𩚷
粗	麄 麤 觕
粘	黏
粛	肅
粜	糶
粝	糲
粟	𥾄 𥸫 𥹟 𠧼 䅇
粤	粵
粥	鬻
粦	㷠 燐
粧	妝
粪	糞
粫	糯
粮	糧
粳	秔 稉
粵	粤
粹	粋
粽	糭 糉
精	精
糁	糝
糂	糝
糇	餱
糉	粽
糊	胡
糓	穀
糕	餻
糖	糖 餹
糙	㿷
糝	糂 糁
糞	𥼇 𥼈 粪
糟	醩
糠	穅
糡	糨
糤	馓 饊
糧	粮
糨	糡
糭	糉
糯	粫 稬 穤
糰	䊜
糲	粝
糴	籴
糶	條 粜
糸	絲 𢆯 糹
糹	糸 纟
糺	糾
系	繫 係
糾	糺 纠
紀	纪
紂	纣
約	约
紅	红
紆	纡
紇	纥
紈	纨
紉	纫
紋	纹
納	纳
紐	紐 纽
紓	纾
純	𠄤 㝄 纯
紕	纰
紖	纼
紗	纱
紘	纮
紙	帋 纸
級	𨸚 级
紛	纷
紜	纭
紝	纴
紟	衿
紡	纺
索	索
紥	紮
紧	緊
紩	鉄
紬	綢 䌷
紮	扎 紥
累	纍
細	细
紱	绂
紲	緤 绁
紳	绅
紵	𦂂 纻
紹	綤 佋 绍
紺	绀
紼	绋
紿	绐
絀	绌
終	𣊂 𤽘 𣧩 𠔾 𡦿 𢍐 𣈩 𤽬 夊 终
絃	弦
組	组
絅	褧 䌹
絆	绊
絋	纊
経	經
絎	绗
絏	紲
結	揭 结
絕	𢇍 𠤉 绝
絖	纊
絚	緪 縆
絛	縚 绦
絝	褲 袴 綯 绔
絞	绞
絡	络
絢	绚
絣	背
絥	鞴
給	给
絨	绒
絪	氤
絰	绖
統	綂 统
絲	纟 丝
絳	绛
絵	繪
絶	絕 绝
絷	縶
絸	繭
絹	绢
綁	绑
綂	統
綃	绡
綆	䋁 绠
綈	绨
綉	繡 绣
綌	绤
綏	夊 绥
綐	䌼
綑	捆
經	経 𦀇 𤔕 坕 经
綕	織
継	繼
続	續
綜	综
綞	缍
綠	綠 氯 绿
綢	紬 绸
綣	绻
綤	紹
綦	𥾟
綫	線 线
綬	绶
維	维
綯	絝 绹
綰	绾
綱	㭃 𣓡 纲
網	网
綳	繃 绷
綴	缀
綵	䌽
綸	纶
綹	绺
綺	绮
綻	䘺 绽
綽	繛 绰
綾	绫
綿	緜 绵
緄	绲
緇	缁
緊	紧
緋	绯
総	總
緑	綠 绿
緒	緖 绪
緓	绬
緔	绱
緖	緒
緗	缃
緘	缄
緙	缂
線	綫 线
緜	綿
緝	缉
緞	缎
締	缔
緡	眠 缗
緣	縁 缘
緤	紲
緥	褓
緦	𦃞 𢆿 缌
編	编
緩	𦅻 缓
緪	絚 縆
緬	缅
緯	纬
緱	缑
緲	眇 缈
練	练
緶	缏
緹	缇
緻	致
緼	縕
縁	緣
縂	總
縄	繩
縆	絚 緪
縈	萦
縉	缙
縊	缢
縋	缒
縐	皺 绉
縑	缣
縕	韞 缊
縗	缞
縚	絛
縛	缚
縝	缜
縞	缟
縟	溽 缛
縣	县
縦	縱
縧	绦
縫	缝
縭	褵 缡
縮	缩
縯	䌥
縱	𥾞 纵
縲	缧
縳	䌸
縴	纤
縵	缦
縶	絷
縷	缕
縹	缥
總	総 搃 摠 𠂳 总
績	绩
繁	緐
繃	綳 绷
繅	繰 𦃨 缫
繆	缪
繈	繦 襁
繊	纖
繋	繫
繍	繡
繒	缯
織	𥿮 綕 𦁓 𦁋 织
繕	缮
繖	傘
繘	𦇹 𦈇
繙	翻
繚	缭
繛	綽
繞	遶 绕
繡	繍 綉 绣
繢	繪 缋
繦	繈 襁
繩	縄 䋲 绳
繪	缋 繢 绘
繫	繋 系
繭	絸 茧
繮	韁 缰
繯	缳
繰	繅 缲
繲	挫
繳	缴
繸	䍁
繹	绎
繼	继
繽	缤
繾	缱
繿	襤 䍀
纂	臇 𤎱
纇	颣
纈	缬
纉	纘
纊	絋 絖 纩
續	賡 续
纍	累
纎	纖
纏	缠
纒	纏
纓	缨
纔	才
纖	砌 纎 纤
纘	纉 缵
纜	䌫 缆
纟	糹
纠	糾
纡	紆
红	紅
纣	紂
纤	縴 纖
纥	紇
约	約
级	級
纨	紈
纩	纊
纪	紀
纫	紉
纬	緯
纭	紜
纮	紘
纯	純
纰	紕
纱	紗
纲	綱
纳	納
纴	紝
纵	縱
纶	綸
纷	紛
纸	紙
纹	紋
纺	紡
纻	紵
纼	紖
纽	紐
纾	紓
线	線 綫
绀	紺
绁	紲
绂	紱
练	練
组	組
绅	紳
细	細
织	織
终	終
绉	縐
绊	絆
绋	紼
绌	絀
绍	紹
绎	繹
经	經
绐	紿
绑	綁
绒	絨
结	結
绔	褲 絝
绕	繞
绖	絰
绗	絎
绘	繪
给	給
绚	絢
绛	絳
络	絡
绝	絕 絶
绞	絞
统	統
绠	綆
绡	綃
绢	絹
绣	繡 綉
绤	綌
绥	綏
绦	絛 縧
继	繼
绨	綈
绩	績
绪	緒
绫	綾
绬	緓
续	續
绮	綺
绯	緋
绰	綽
绱	緔 鞝
绲	緄
绳	繩
维	維
绵	綿
绶	綬
绷	繃 綳
绸	綢
绹	綯
绺	綹
绻	綣
综	綜
绽	綻
绾	綰
绿	綠 緑
缀	綴
缁	緇
缂	緙
缃	緗
缄	緘
缅	緬
缆	纜
缇	緹
缈	緲
缉	緝
缊	縕
缋	繪 繢
缌	緦
缍	綞
缎	緞
缏	緶
缐	線
缑	緱
缒	縋
缓	緩
缔	締
缕	縷
编	編
缗	緡
缘	緣
缙	縉
缚	縛
缛	縟
缜	縝
缝	縫
缞	縗
缟	縞
缠	纏
缡	縭
缢	縊
缣	縑
缤	繽
缥	縹
缦	縵
缧	縲
缨	纓
缩	縮
缪	繆
缫	繅
缬	纈
缭	繚
缮	繕
缯	繒
缰	繮 韁
缱	繾
缲	繰
缳	繯
缴	繳
缵	纘
缶	罐 缻
缷	卸
缸	堈 罁
缺	欠
缻	缶
缽	鉢 钵
缾	瓶
罁	堈 缸
罂	罌
罃	甖 罌
罅	𨻲
罇	樽 墫
罈	墰 壜 坛
罋	瓮 甕
罌	甖 罃 罂
罍	𦉩
罐	缶 礶
网	㓁 罔 𠕃 𦉽 𦋟 𦉮 網
罔	网 𡦽 𡧏
罗	囉 羅
罘	罦
罚	罰
罟	𦊖
罢	罷
罥	羂
罩	䈇
罪	辠 𡈚
置	寘 𦌃 𦌤 𦋽 𦋲
罰	罸 罚
署	穎
罴	羆
罵	傌 骂
罶	羀
罷	罢
罹	罹
羀	罶
羁	羈
羂	罥
羃	冪
羅	羅 罗
羆	𥀦 𥀍 𥀧 罴
羇	羈
羈	覊 䩭 羁
羋	芈
羌	𡹽 羗
美	羙
羐	誘
羓	豝
羖	𦍩
羗	羌
羙	美
羚	羚
羝	牴
羟	羥
羡	羨
羣	群
群	羣
羥	羟
羨	羡
義	义
羮	羹
羴	羶
羶	羴 膻
羹	羮
羽	羽
翄	翅
翅	翄
翆	翠
翍	披
習	习
翘	翹
翚	翬
翠	翆
翥	䬡
翦	𦑳 剪
翬	翚
翱	翺
翶	翱
翹	翘
翺	翱
翻	繙
翼	𦏵 折
翽	翙
耀	曜 燿
老	耂 𠄰
耂	老
考	攷
耄	𧂕
耇	耈
耈	耇
耉	耈
耏	耐
耐	耏
耑	專 端
耒	來
耔	秄
耕	畊 簡
耗	秏
耘	秐
耙	鈀
耡	鋤
耢	耮
耤	藉
耧	耬
耨	鎒
耬	𦔪 耧
耮	耢
耰	櫌
耸	聳
耻	恥
耼	聃
耽	躭 𤯉
耿	炅 熲
聂	聶
聃	耼
聆	聆
聋	聾
职	職
聍	聹
聒	𠅪 𦗾
联	聯
聖	堊 𦕡 𠄵 圣
聝	馘
聞	𦕁 䎽 䎹 𦖫 𥹢 闻
聟	婿
聡	聰
聦	聰
聨	聯
聩	聵
聪	聰
聫	聯
聮	聯
聯	聨 联
聰	聡 聦 聪
聲	殸 声
聳	耸
聴	聽
聵	聩
聶	聂
職	軄 职
聹	聍
聻	魙
聼	聽
聽	𦕢 听
聾	聾 聋
聿	肀
肀	聿
肃	肅
肅	粛 𦘡 䏋 𢙻 肃
肆	四 𦘨 𢑨
肇	肈
肈	肇
肉	宍
肋	肋
肐	胳 𩨘
肕	韌
肠	腸
股	脵 𦙶
肢	胑
肤	膚
肧	胚
肨	胮
肬	疣
肮	骯
肯	肻 𣍟
肰	𦛦 𦛡 𦝸
肱	𠃋 厷 𠫔
育	毓
肳	吻
肴	餚
肻	肯
肾	腎
肿	腫
胀	脹
胁	脅
胄	冑 伷
胆	膽
胊	朐
背	絣
胑	肢
胓	𦚓
胔	骴
胗	疹
胙	作
胚	肧
胜	勝
胝	郅
胞	脬
胡	楜 衚 鬍
胤	𦞩
胥	𦙃
胧	朧
胨	腖
胪	臚
胫	脛
胭	臙
胮	肨
胯	骻
胳	肐 𩨘
胶	膠
胷	胸 匈
胸	胷 匈
胼	腁
脃	脆
脅	脇 勰 胁
脆	脃
脇	脅
脈	衇 脉
脉	䘑 脈 衇
脍	膾
脏	髒 臟
脐	臍
脑	腦
脓	膿
脔	臠
脚	腳
脛	胫
脣	唇 䫃
脧	朘
脪	㾙
脫	脱
脬	胞
脱	脫
脲	尿
脳	腦
脵	股
脶	腡
脸	臉
脹	痮 胀
脼	朗
腁	胼
腆	䐌
腊	臈 臘
腌	骯
腎	肾
腕	𦙵
腖	胨
腘	膕
腟	膣
腡	脶
腢	髃
腦	匘 脑
腫	尰 肿
腭	齶
腮	顋
腳	脚
腸	膓 肠
腻	膩
腼	靦
腽	膃
腾	騰
腿	骽
膃	腽
膆	嗉
膋	膫
膑	臏
膕	腘
膘	臕
膚	肤
膠	胶
膣	腟
膩	腻
膫	膋
膳	饍
膸	髓
膺	𦢻
膻	羶
膽	胆
膾	鱠 脍
膿	脓
臇	𤎱 纂
臈	臘 腊
臉	脸
臊	𦞣
臍	脐
臏	髕 膑
臓	臟
臕	膘
臘	腊 臈
臙	胭
臚	胪
臜	臢
臞	癯
臟	脏
臠	脔
臢	臜
臣	𢘑
臤	賢
臥	卧
臨	臨 𦣷 临
自	𦣹 鼻
臯	皋
至	𦤳 𦤴 𦤵 𡊏
致	緻
臺	台 𡌫 㙵
舀	抌 外
舁	𦥠
舃	舄
舄	舃
舆	輿
與	与 𢌱 𦦲 𠔔
興	㒷 兴
舉	擧 㪯 举
舊	旧
舍	舎 捨
舎	舍
舐	舓
舒	摴
舓	舐
舔	餂
舖	鋪
舗	鋪
舘	館
舙	咠
舜	𡐩 𡳈 𡳉
舞	𦐀
舡	船
舣	艤
舦	艜
舩	船
般	𦨗
舮	櫓
舰	艦
舱	艙
舵	柁
舶	艊
船	舩 舡
舻	櫓 艫
艁	造
艇	𦨿
艊	舶
艐	屆
艑	扁
艙	舱
艜	舦
艢	檣
艣	櫓
艤	舣
艥	楫 檝
艦	舰
艪	櫓 樐
艫	櫓 舻
良	良 𡰩 𥭣 𡆨
艰	艱
艱	𡆒 囏 艰
色	𢒸
艳	豔 艷
艴	勃
艶	豓 豔
艷	豔 艳
艸	草 艹
艹	艸 草
艺	藝
艽	韭
节	節
芈	羋
芊	茜
芒	杧
芔	𠦄 卉
芗	薌
芘	蔽
芛	茟
芜	蕪
芟	𠚹
芦	蘆
芭	巴
芰	茤 𦼽
花	蘤
芸	藝 蕓
芻	蒭 𦷝 刍
苁	蓯
苃	𢇬
苅	刈
苇	葦
苈	藶
苋	莧
苌	萇
苍	蒼
苎	蒙 苧
苏	蘇
苑	菀
苓	蓮
苕	䒒
苗	𡩈
苛	哼
苟	茍 𠷜
苡	苢
苢	苡
苤	瞥
若	若 𦱡 𦱶 𧁇
苧	薴 苎
苹	蘋
苺	莓
苽	菇
苿	菋
茂	楙
范	範
茄	伽
茅	泖
茆	茅
茈	柴
茊	茲
茍	苟
茎	莖
茏	蘢
茑	蔦
茔	塋
茕	煢
茘	荔
茟	芛
茠	薅
茤	芰
茧	繭
茭	椒 𦺏
茲	玆 兹 𦱳 茊
茶	茶
荅	答
荆	荊 𦮓
荇	莕
草	艸 艹 屮
荊	荆
荍	蕎
荐	薦
荒	𠃤 𠯚
荔	栛
荘	莊
荙	薘
荚	莢
荛	蕘
荜	蓽
荝	萴
荞	蕎
荟	薈
荠	薺
荡	盪 蕩
荣	榮
荤	葷
荥	滎
荦	犖
荧	熒
荨	蕁
荩	藎
荪	蓀
荫	蔭
荬	蕒
荭	葒
荮	葤
药	葯 藥
荳	豆
荶	䕾
荽	萎
莀	農
莅	涖 蒞
莆	蒲
莊	荘 𤖄 𤖈 𦻊 𠗎 𤕶 庄
莓	苺
莕	荇
莖	茎
莜	蓧
莢	荚
莧	苋
莩	殍
莫	𦮅 䒬 𦱴
莱	萊
莲	蓮
莳	蒔
莴	萵
莵	菟
莶	薟
获	穫 獲
莸	蕕
莹	瑩
莺	鶯
莼	蒓 蓴
莿	朿 刺
菀	苑
菅	𦭂
菇	苽 菰
菋	苿
菌	蕈 滾
菑	𠙹 𠙾 𠚀 災 灾 烖 甾
菓	果
菔	蔔
菝	蔽
菟	莵
菢	勽
菤	𦶘
菫	堇 䒺 𦻍 𦸧 𦻋 𦸨
華	崋 䔢 蕐 华
菰	苽 菇
菱	菱 𧅊
菴	庵 葊
菷	帚
菸	烟 煙
菻	麻
萁	𦬟
萅	春
萆	蔽 蓖
萇	苌
萊	莱
萌	萠 鋂
萎	荽
萚	蘀
萝	蘿
萠	萌
萤	螢
营	營
萦	縈
萧	蕭
萨	薩
萬	万 卍 㸘 𤍚 𢁭
萱	萲
萲	萱
萵	莴
萼	蕚
落	落
葁	薑
葉	葉 叶
葊	菴
葒	荭
著	着 螫
葚	椹
葢	蓋 盖
董	𦱦
葤	荮
葦	苇
葫	胡
葬	塟 𦽱 𦱼 𧂥 𦿑
葯	藥 药
葱	蔥
葷	荤
蒀	馧
蒇	蕆
蒉	蕢
蒋	蔣
蒌	蔞
蒍	蔿
蒓	蓴 莼
蒔	莳
蒙	懞
蒞	涖 莅
蒭	芻
蒲	莆
蒸	烝
蒼	𡶍 𦭆 苍
蓀	荪
蓆	席
蓋	𤇁 盖 葢
蓍	𦮂
蓑	𠱗 𡔤
蓖	芘 萆
蓝	藍
蓟	薊
蓠	蘺
蓡	參
蓣	蕷
蓥	鎣
蓦	驀
蓧	莜
蓮	苓 莲
蓯	苁
蓴	蒓 莼
蓺	埶 秇 藝
蓼	蓼
蓽	𦸩 荜
蔂	虆
蔔	菔 卜
蔚	嶎
蔞	褸 蒌
蔡	𣞖
蔣	蒋
蔥	葱
蔦	茑
蔭	廕 荫
蔴	麻
蔵	藏
蔷	薔
蔹	蘞
蔺	藺
蔼	藹
蔽	芘
蔿	蒍
蕁	荨
蕆	蒇
蕈	菌
蕊	蘂 蕋
蕋	蕊
蕎	荍 荞
蕐	華
蕒	荬
蕓	芸
蕕	莸
蕘	荛
蕚	萼
蕡	𦶁
蕢	𤆂 簣 籄 蒉
蕣	橓
蕤	甤
蕩	偒 盪 蘯 荡
蕪	芜
蕭	萧
蕰	薀
蕲	蘄
蕴	蘊 藴
蕷	蓣
薀	蕰
薅	茠
薈	荟
薊	蓟
薌	芗
薏	𦺳
薑	姜 葁
薓	參
薔	蔷
薘	荙
薟	蘞 莶
薦	𧲛 荐
薩	萨
薫	薰
薬	藥
薮	藪
薯	藷
薰	薫
薳	䓕
薴	苧
薺	萕 荠
藇	𨣦
藉	借 𧃫 耤
藍	蓝
藎	荩
藏	蔵 匨
藓	蘚
藝	兿 秇 埶 蓺 艺
藟	蘽
藤	籐
藥	薬 葯 药
藦	蘑
藪	籔 薮
藴	蘊 蕴
藶	苈
藷	薯
藹	蔼
藺	蔺
蘀	萚
蘂	蕊
蘄	蕲
蘆	蘆 芦
蘇	苏
蘊	蕴
蘋	苹
蘎	驥
蘏	蘔
蘑	藦
蘓	蘇
蘔	蘏
蘖	蘗 櫱
蘗	檘
蘘	𧅍
蘚	藓
蘞	薟 蔹
蘢	茏
蘤	花
蘧	𠙢
蘬	𦺕
蘭	兰
蘯	盪 蕩
蘺	蓠
蘽	藟
蘿	蘿 萝
虆	蔂
虍	𧇁
虎	乕 𧇂 虝 𪊖
虏	虜
虐	乇 𧆱 𣑅 䖈
虑	慮
虓	唬 猇
虔	䖍
處	処 䖏 处
虖	呼 乎
虚	虛
虛	𣦄 虚
虜	虜 擄 虏
虝	虎
虞	𠈌 吳 𩦢
號	号
虡	𧇆
虣	暴
虧	亏
虫	蟲 虺
虬	蚪 虯
虮	蟣
虯	虬
虱	蝨
虺	蝰 虫
虽	雖
虾	蝦
虿	蠆
蚀	蝕
蚁	蟻
蚂	螞
蚃	蠁
蚊	螡 蟁
蚋	蜹
蚓	螾
蚔	𧏁
蚕	蠶
蚘	痐 蛔 蛕
蚝	螆
蚤	䖣
蚦	蚺
蚪	虬
蚬	蜆
蚺	蚦
蛄	蛌
蛆	𧐅
蛊	蠱
蛋	旦 蜑
蛌	蛄
蛍	螢
蛎	蠣
蛏	蟶
蛓	螆
蛔	蜖 蚘 蛕
蛕	蚘 蛔
蛗	𧌓
蛙	鼃 䵷
蛛	鼄
蛮	蠻
蛰	蟄
蛱	蛺
蛲	蟯
蛳	螄
蛴	蠐
蛺	蛱
蛻	蜕
蜂	蠭
蜆	蚬
蜇	𧋍
蜋	螂
蜍	蠩
蜑	蛋
蜕	蛻
蜖	蛔
蜗	蝸
蜘	鼅
蜜	𦸞
蜝	蜞
蜞	蜝
蜡	䄍 蠟 蜡
蜨	蝶
蜫	䖵
蜶	蟀
蜹	蚋
蜺	霓
蝃	螮
蝇	蠅
蝈	蟈
蝉	蟬
蝋	蠟
蝎	蠍
蝕	蚀
蝟	猬
蝥	蟊
蝦	鰕 虾
蝨	虱
蝯	猨 猿
蝱	䖟
蝴	胡
蝶	蜨
蝸	蜗
蝼	螻
蝾	蠑
蝿	蠅
螀	螿
螂	蜋
螄	蛳
螆	蚝 蛓
融	螎
螎	融
螗	螳
螘	蟻
螙	蠹 蠧
螞	蚂
螢	蛍 萤
螨	蟎
螫	著
螬	𧕐
螮	蝃 䗖
螳	螗
螵	蜱
螺	螺 蠃
螻	蝼
螽	𧕠
螾	蚓
螿	螀
蟀	蜶
蟁	蚊
蟄	蛰
蟇	蟆
蟈	蝈
蟊	𧐘 蝥
蟎	螨
蟏	蠨
蟒	蠎
蟚	蟛
蟛	蟚
蟣	虮
蟬	蝉
蟮	蟺
蟯	蛲
蟲	虫
蟶	蛏
蟹	蠏
蟺	蟮
蟻	螘 蚁
蠁	蚃
蠃	螺
蠅	蝇
蠆	虿
蠍	蝎
蠎	蟒
蠏	蟹
蠐	蛴
蠑	蝾
蠔	𧐢
蠟	蜡
蠡	𢍝 𥯵
蠢	惷 𢧋
蠣	蛎
蠧	蠹 螙
蠨	蟏
蠩	蜍
蠭	𧒒 蜂
蠱	蛊
蠶	蚕
蠹	蠧 螙
蠻	蛮
衂	衄
衄	衂
衅	釁
衆	眾 𠂝 众
衇	脈 脉
行	行
衒	炫
術	术
衔	銜
衕	同
街	亍
衚	胡
衛	衞 卫
衝	𧘂 冲
衞	衛
衟	道
衡	𡘻 𡙉
衣	衤
衤	衣
补	補
表	𧘝 𧞧 𧜫 錶
衬	襯
衮	𧚹 袞
衰	𠆂 𠌺
衹	只
衽	袵
衿	紟 襟
袄	襖
袅	嬝 裊
袆	褘
袋	帒
袒	襢
袖	褎 褏
袜	襪
袞	衮
袠	帙
袭	襲
袯	襏
袴	褲 絝
袵	衽
袷	裌
裂	裂
装	裝
裆	襠
裈	褌
裉	褃
裊	嬝 袅
裌	袷
裏	里 裡 里
裒	鴄
裔	𧘉 𧘊
裘	求
裙	帬 裠 𧛬
補	𢒏 补
裝	装
裠	裙
裡	裏 里
裢	褳
裣	襝
裤	褲
裥	襇
裴	裵
裵	裴
裸	裸 躶 𡑤
製	制
褃	裉
複	復 复
褌	裈
褎	褏
褏	褎 袖
褒	襃
褓	褴 緥
褘	袆
褛	褸
褟	溻
褢	褱
褧	絅
褱	褢 懷
褲	綯 絝 袴 裤
褳	裢
褴	褓 襤
褵	縭
褶	襲
褸	蔞 褛
褺	䙝 褻
褻	䙝 褺 亵
襁	繈 繦
襃	褒
襄	㐮 𡣿 𠆝 𧞜
襇	裥
襍	雜
襏	袯
襕	襴
襖	澳 𥜌 袄
襜	襝 輦
襝	襜 裣
襟	衿
襠	裆
襢	袒
襤	襤 褴
襪	韈 袜 韤
襬	䙓
襮	幞 𧟊
襯	儭 衬
襲	㦻 𧟛 褶 袭
襴	幱
襾	西
西	覀 𠧧 㢴
覀	西
要	𡢗 𦥼 𠾅
覃	𪉙 𪉞 𪉲
覆	復 复
覇	霸
覈	核
覉	羈
覊	羈
見	见
覌	觀
覎	觃
規	槻 规
覐	覺
覓	覔 觅
覔	覓
視	眎 𥄙 眡 𥄚 𥅭 𥉙 𤋇 视
覘	䦓 𦕒 觇
覙	覼
覚	覺
覡	觋
覥	靦 觍
覦	觎
覩	睹
親	𢈥 寴 𡩁 亲
覬	觊
覯	觏
覰	覷
覲	觐
観	觀
覵	覸
覷	覰 觑
覸	覵
覺	覚 覐 𧠭 斍 觉
覽	覧 览
覿	觌
觀	覌 𥍊 𥸑 𥷯 观
见	見
观	觀
觃	覎
规	規
觅	覓
视	視
觇	覘
览	覽
觉	覺
觊	覬
觋	覡
觌	覿
觍	覥
觎	覦
觏	覯
觐	覲
觑	覷
角	甪
觔	斤
觕	粗 麄 麤
觜	咀 嘴
觝	牴
觞	觴
解	觧
觥	觵
触	觸
觧	解
觯	觶
觴	觞
觵	觥
觶	𧣄 觯
觸	𧢻 触
言	訁 𢍗 𢍬
訁	讠
訂	订
訃	讣
訇	渹 𢕐
計	计
訊	𧨼 訙 𧫓 䛜 𠱖 讯
訌	讧
討	讨
訐	讦
訒	讱
訓	𧥥 馴 训
訕	讪
訖	讫
託	侂 讬
記	记
訙	訊
訚	誾
訛	譌 讹
訝	讶
訟	䛦 𧧡 吅 㕬 讼
訠	矧
訢	䜣
訣	诀
訥	吶 讷
訦	諶
訩	詾 讻
訪	访
設	设
許	许
訳	譯
訴	愬 诉
訶	呵 㱒 诃
診	诊
註	注
証	證
訽	詬
詁	诂
詆	诋
詋	呪
詎	讵
詐	醡 诈
詒	诒
詔	诏
評	评
詖	诐
詗	诇
詘	诎
詛	𥛜 謯 诅
詞	𧥝 词
詟	讋
詠	咏
詡	诩
詢	询
詣	诣
詤	謊
試	试
詧	察
詩	𧥳 诗
詫	诧
詬	訽 呴 诟
詭	诡
詮	诠
詰	诘
話	䛡 𦧵 话
該	该
詳	详
詵	侁 駪 诜
詶	酬
詻	咯
詼	诙
詾	訩
詿	诖
誄	诔
誅	诛
誆	诓
誇	夸 𧥢
誉	譽
誊	謄
誌	志
認	认
誐	哦
誑	诳
誒	唉 诶
誓	𣂶 𣂯
誕	𧩙 诞
誖	𢨋
誘	䛻 羐 诱
誚	譙 诮
語	语
誠	诚
誡	诫
誣	诬
誤	悞 误
誥	𢍎 𧧞 𧧙 诰
誦	诵
誨	𠲯 诲
誩	競 𧮣
說	説 说
説	說 说
読	讀
誰	谁
課	课
誶	谇
誹	诽
誼	谊
誾	訚
調	调
諁	啜
諂	谄
諄	𧭫 谆
諅	𧥽
談	譚 谈
諉	餵 诿
諊	鞫
請	请
諌	諫
諍	诤
諏	诹
諑	诼
諒	谅
諕	唬
論	論 论
諗	谂
諛	谀
諜	谍
諝	谞
諞	谝
諠	喧
諡	謚
諢	诨
諤	讍 囮 谔
諦	谛
諧	龤 谐
諩	譜
諫	𧧅 谏
諭	谕
諮	咨 嗞 谘
諱	讳
諳	谙
諵	喃
諶	訦 谌
諷	讽
諸	𢒕 诸
諺	𠷗 谚
諼	煖 谖
諾	喏 诺
謀	𠰔 𧦥 谋
謁	谒
謂	谓
謄	誊
謅	诌
謊	詤 谎
謌	歌
謎	谜
謐	谧
謔	谑
謕	啼
謖	谡
謗	谤
謙	𥡝 谦
謚	諡 谥
講	讲
謝	谢
謠	谣
謡	謠 谣
謨	𠻚 𢜯 譕 谟
謫	讁 谪
謬	谬
謭	谫
謯	詛
謱	嘍
謳	讴
謹	谨
謼	呼
謾	谩
譁	哗 嘩
譅	䜧
譈	憝 懟
證	𨨾 証 证
譌	訛
譎	憰 谲
譏	讥
譐	噂
譕	謨
譖	谮
識	𧨺 识
譙	誚 谯
譚	談 谭
譜	谱
譟	噪
警	儆
譫	谵
譭	䛼
譯	訳 译
議	议
譱	善
譲	讓
譴	谴
護	护
譸	𡆓 𡃮 𧪀 诪
譼	監
譽	域 誉
譾	謭 谫
讀	讀 读
讁	謫
讃	讚
讅	谉
讆	讏
變	変 𢒟 𢒪 𢒦 变
讋	詟
讌	燕 宴
讍	諤
讎	仇 𢢧 𠵁 𢛇 讐 雠
讐	仇 讎
讒	谗
讓	𦦬 让
讕	谰
讖	谶
讘	囁
讙	歡
讚	讃
讜	谠
讞	谳
讟	㾄
讠	言 訁
计	計
订	訂
讣	訃
认	認
讥	譏
讦	訐
讧	訌
讨	討
让	讓
讪	訕
讫	訖
讬	託
训	訓
议	議
讯	訊
记	記
讱	訒
讲	講
讳	諱
讴	謳
讵	詎
讶	訝
讷	訥
许	許
讹	訛
论	論
讻	訩
讼	訟
讽	諷
设	設
访	訪
诀	訣
证	證
诂	詁
诃	呵 訶
评	評
诅	詛
识	識
诇	詗
诈	詐
诉	訴
诊	診
诋	詆
诌	謅
词	詞
诎	詘
诏	詔
诐	詖
译	譯
诒	詒
诓	誆
诔	誄
试	試
诖	詿
诗	詩
诘	詰
诙	詼
诚	誠
诛	誅
诜	詵
话	話
诞	誕
诟	詬
诠	詮
诡	詭
询	詢
诣	詣
诤	諍
该	該
详	詳
诧	詫
诨	諢
诩	詡
诪	譸
诫	誡
诬	誣
语	語
诮	誚
误	誤
诰	誥
诱	誘
诲	誨
诳	誑
说	說 説
诵	誦
诶	唉 誒
请	請
诸	諸 諸
诹	諏
诺	諾
读	讀
诼	諑
诽	誹
课	課
诿	諉
谀	諛
谁	誰
谂	諗
调	調
谄	諂
谅	諒
谆	諄
谇	誶
谈	談
谉	讅
谊	誼
谋	謀
谌	諶
谍	諜
谎	謊
谏	諫
谐	諧
谑	謔
谒	謁
谓	謂
谔	諤
谕	諭
谖	諼
谗	讒
谘	咨 諮
谙	諳
谚	諺
谛	諦
谜	謎
谝	諞
谞	諝
谟	謨
谠	讜
谡	謖
谢	謝
谣	謠 謡
谤	謗
谥	謚
谦	謙
谧	謐
谨	謹
谩	謾
谪	謫
谫	謭 譾
谬	謬
谭	譚
谮	譖
谯	譙
谰	讕
谱	譜
谲	譎
谳	讞
谴	譴
谵	譫
谶	讖
谷	穀
谾	豅
谿	嵠
豄	𨽍
豅	谾
豆	𣅋 𤽋 𣅣 荳
豇	䜶
豈	岂
豊	豐
豋	𧰍 登
豎	竪 竖
豐	豊 𣍈 𧯮 丰
豑	秩
豓	艶 豔
豔	艶 豓
豕	𢁓 𧰧 𡰯
豘	豚
豚	豘
豜	豣
豝	羓
豟	𧲒
象	𤉢
豣	豜
豫	予 𠄛 預
豬	猪
豮	豶
豳	㟗 邠
豴	蹢
豵	䝋
豶	豮
豸	廌
豺	犲
豻	犴
貂	鼦
貉	狢
貊	貘
貌	皃 𧳒
貍	狸
貎	皃
貓	猫
貘	貊
貙	䝙
貛	獾
貝	敗 贝
貞	𠨀 贞
貟	贠
負	负
財	㒲 才 财
貢	贡
貧	𡧋 贫
貨	䞈 𣱷 货
販	𧶶 贩
貪	贪
貫	贯
責	𧵩 拆 责
貭	質
貮	二
貯	贮
貰	贳
貲	赀
貳	二 弍 贰
貴	𡭙 𧸋 贵
貶	贬
買	买
貸	贷
貺	𧵮 贶
費	费
貼	贴
貽	贻
貿	贸
賀	贺
賁	贲
賂	赂
賃	赁
賄	贿
賅	侅 赅
資	资
賈	贾
賉	恤
賊	戝 贼
賍	贓 贜
賑	赈
賒	赊
賓	𧶉 𡫅 𥦎 𡧍 賔 宾
賔	賓
賕	赇
賙	赒
賚	赉
賛	贊
賜	赐
賞	赏
賠	赔
賡	續 赓
賢	臤 贒 贤
賣	売 𧷨 卖
賤	𧶤 贱
賦	赋
賧	赕
質	貭 质
賫	齎 赍
賬	帳 账
賭	赌
賮	贐
賰	䞐
賴	𩓃 頼 赖
賵	𠙒 赗
賸	剩
賺	贃 𧸖 赚
賻	赙
購	购
賽	赛
賾	𡄙 赜
贁	敗
贃	賺 𧸖
贄	贽
贅	𧷌 𧸆 赘
贇	赟
贈	赠
贊	賛 赞
贋	偐 贗 赝
贍	赡
贏	赢
贐	賮 赆
贒	賢
贓	賍 贜 赃
贔	赑
贖	赎
贗	贋 偐 赝
贛	赣
贜	贓 賍 赃
贝	貝
贞	貞
负	負
贠	貟
贡	貢
财	財
责	責
贤	賢
败	敗
账	帳 賬
货	貨
质	質
贩	販
贪	貪
贫	貧
贬	貶
购	購
贮	貯
贯	貫
贰	二 貳
贱	賤
贲	賁
贳	貰
贴	貼
贵	貴
贶	貺
贷	貸
贸	貿
费	費
贺	賀
贻	貽
贼	賊
贽	贄
贾	賈
贿	賄
赀	貲
赁	賃
赂	賂
赃	贓 贜
资	資
赅	賅
赆	贐
赇	賕
赈	賑
赉	賚
赊	賒
赋	賦
赌	賭
赍	賫 齎
赎	贖
赏	賞
赐	賜
赑	贔
赒	賙
赓	賡
赔	賠
赕	賧
赖	賴
赗	賵
赘	贅
赙	賻
赚	賺
赛	賽
赜	賾
赝	贋 贗
赞	贊
赟	贇
赠	贈
赡	贍
赢	贏
赣	贛
赤	𤆍 烾
赦	𤆅
赨	雄
赪	赬
赬	䞓 赪
走	赱 㞫
赱	走
赵	趙
赶	趕
起	𨑓 𡆡 𨑔
趁	趂
趂	趁
趄	跙
越	𦈭 𧻂
趋	趨
趒	跳
趕	赶
趙	赵
趨	趋
趮	躁
趯	躍
趱	趲
趲	趱
足	疋 𤴕
趸	躉
跃	躍
跄	蹌
跐	跴
跖	蹠
跙	趄
跛	㝿
跞	躒
跡	蹟 迹 速
跥	跺
路	路
跳	趒
跴	踹 跐
践	踐
跶	躂
跷	蹺
跸	蹕
跹	躚
跺	跥
跻	躋
踁	硜
踆	蹲
踊	踴
踌	躊
踏	蹋
踐	践
踑	䟚
踖	𨅦
踦	犄
踨	蹤
踪	蹤
踬	躓
踭	㬹
踯	躑
踰	逾
踴	踊
踵	歱
踹	跴
踽	偊
蹄	蹏
蹈	𨂆
蹋	踏 蹹
蹌	牄 跄
蹏	蹄
蹑	躡
蹒	蹣
蹕	跸
蹝	屣 躧
蹟	跡 迹 速
蹠	𨂂 跖
蹢	𨅙 豴
蹣	蹒
蹤	踨 踪
蹧	遭
蹭	矰
蹮	躚
蹯	籵
蹰	躕
蹲	踆
蹴	蹵
蹵	蹴
蹶	蹷
蹷	蹶
蹹	蹋
蹺	蹻 跷
蹻	蹺
蹿	躥
躁	趮
躂	跶
躅	𨄃 䠱
躉	趸
躊	踌
躋	𢁃 䠁 𤼥 隮 跻
躍	趯 跃
躏	躪
躑	踯
躒	跞
躓	踬
躕	蹰
躗	躛
躚	蹮 跹
躛	躗
躜	躦
躡	蹑
躥	蹿
躦	躜
躧	屣 蹝
躪	躏
躬	躳
躭	耽 眈
躯	軀
躰	體
躱	躲
躲	躱
躳	躬
躶	裸
躷	矮
軀	躯
軄	職
軆	體 体
車	𠦴 车
軋	轧
軌	𨑍 𧗝 轨
軍	𡗽 军
軑	轪
軒	轩
軔	轫
軙	陳
軛	轭
軟	輭 软
転	轉
軣	轟
軤	轷
軫	轸
軰	輩
軲	轂 轱
軸	轴
軹	轵
軺	𨍳 轺
軻	轲
軼	轶
軽	輕
軾	轼
軿	輧
較	较
輅	辂
輇	辁
輈	辀
載	𡙺 儎 载
輊	轾
輌	輛
輒	輙 辄
輓	挽
輔	辅
輕	𨌷 𨓷 轻
輙	輒
輛	輌 辆
輜	辎
輝	煇 辉
輞	辋
輟	𨌸 辍
輥	辊
輦	輦 𨍻 襜 辇
輧	軿
輩	軰 辈
輪	輪 轮
輬	辌
輭	軟
輯	辑
輳	辏
輵	轕
輸	输
輻	輻 辐
輼	轀
輾	辗
輿	轝 舆
轀	辒
轂	𨍔 軲 毂
轄	鎋 辖
轅	辕
轆	樚 辘
轉	転 转
轍	辙
轎	轿
轔	辚
轕	輵
轗	㙳
轝	輿
轟	轰
轡	辔
轢	轢 轹
轤	轳
车	車
轧	軋
轨	軌
轩	軒
轪	軑
轫	軔
转	轉
轭	軛
轮	輪
软	軟
轰	轟
轱	軲
轲	軻
轳	轤
轴	軸
轵	軹
轶	軼
轷	軤
轸	軫
轹	轢
轺	軺
轻	輕
轼	軾
载	載
轾	輊
轿	轎
辀	輈
辁	輇
辂	輅
较	較
辄	輒
辅	輔
辆	輛
辇	輦
辈	輩
辉	輝
辊	輥
辋	輞
辌	輬
辍	輟
辎	輜
辏	輳
辐	輻
辑	輯
辒	轀
输	輸
辔	轡
辕	轅
辖	轄
辗	輾
辘	轆
辙	轍
辚	轔
辜	𢩍 𢻄 𡱨 𡲞
辞	辤 辭
辟	避 𠈳 𠊸
辠	罪
辢	辣
辣	辢
辤	辞 辭
辦	办
辧	辨
辨	弁 辯
辩	辯
辫	辮
辭	辞 辤 𤔧
辮	辫
辯	辨 辩
辰	辰 𠩟 𠨷 𨑄
辱	𢟲
農	莀 䢉 𦦥 辳 𨑇 𣊤 𨑋 𨑆 𦦤 农
辳	農
辵	辶
辶	辵
边	邊
辺	邊
辽	遼
达	達
迁	遷
迂	遇
迆	迤
过	過
迈	邁
迊	匝 帀
运	運
近	𣥍
迕	忤
还	還
这	這
进	進
远	遠
违	違
连	連
迟	遲
迣	迾
迤	迆
迥	逈
迨	逮
迩	邇
迪	廸
迫	廹
迬	往
迭	疊
迯	逃
迳	徑 逕
迴	回 廻
迹	跡 蹟 𨒏 速
迺	乃 廼
迻	移 拪
追	隨
迾	迣
退	𨓆 𨑧 𢓴 𢓇 𨔫
送	𨕪 𨕩
适	適
逃	迯 𨒯
选	選
逊	遜
逎	遒
逐	𢄘
递	遞
逓	遞
逕	徑 迳
逖	逷
這	这
通	𢓶
逞	期
速	𧫣 跡
造	艁
連	連 连
逥	回
逦	邐
逩	奔
逭	𨙕
逮	迨 逯
逯	逮
逰	游
週	周
進	𨙟 𨗃 进
逷	逖
逸	逸 𤖍
逹	達
逺	遠
逻	邏
逼	偪
逾	踰 㢏
逿	盪 𨌩
遀	隨
遁	𨔡 𨘹 𨙆
遂	𨒉 𨔱 𨓸 𨔲
遄	𨒎
遅	遲
遇	𠓱
遊	游 𨒰 汓 𨓎
運	𨔪 运
遍	徧
過	过
遑	徨
遒	逎
道	𨕥 衟 𡬹
達	达
違	违
遗	遺
遙	𨖈 遥
遜	愻 逊
遞	逓 递
遟	遲
遠	逺 𨖸 𢕱 远
遡	溯 泝
遥	遙
適	适
遭	蹧
遲	遅 邌 迟
遵	𨘊 𢍲
遶	繞
遷	迁 𨔰 𨙞 拪 𢰕 𢫥
選	选
遺	𨗮 𨖽 𨗭 遗
遼	遼 辽
避	辟 𨓶 𢕾
邁	迈
還	还
邅	㣶
邇	迩 𨖹
邉	邊
邊	边 𦍇
邌	遲
邏	邏 逻
邐	逦
邑	阝
邓	鄧
邕	雍
邝	鄺
邠	㟗 豳
邢	郉
邦	𤰫 𨚚 邫
邨	村
邫	邦
邬	鄔
邮	郵
邹	鄒
邺	鄴
邻	鄰
郁	喐 鬱
郄	隙 郤
郅	胝
郉	邢
郎	郞
郏	郟
郐	鄶
郑	鄭
郓	鄆
郛	𡎽
郞	郎
郟	郏
郤	郄
郦	酈
郧	鄖
部	卩
郭	𨟍
郰	鄹
郵	邮
郷	鄉
郸	鄲
都	都 𨛷
鄆	郓
鄉	郷 鄕 乡
鄒	邹
鄔	塢 邬
鄕	鄉
鄖	郧
鄙	𠴿
鄧	邓
鄭	郑
鄰	隣 厸 邻
鄲	郸
鄴	邺
鄶	郐
鄷	酆
鄹	郰
鄺	邝
酂	酇
酆	鄷
酇	酂
酈	郦
酉	丣 酋
酋	酉
酔	醉
酖	鴆
酝	醞 醖
酢	醋 榨
酦	醱
酧	酬 醻
酪	酪
酬	酧 醻
酱	醬
酸	𨢽
酹	儡
酽	釅
酾	釃
酿	釀
醃	腌
醇	𨣳 䣩
醉	酔
醊	餟
醋	酢
醑	湑
醒	惺
醖	醞 酝
醗	醱
醜	媿 𥆞 丑
醞	酝
醡	榨 詐
醤	醬
醩	糟
醫	医
醬	𨟻 酱
醱	酦
醴	醴
醻	酬 酧
醼	燕
釀	醸 酿
釁	衅
釃	酾
釅	酽
釆	采 𤓳
采	釆 埰 採
釈	釋
释	釋
釋	释
里	裏 裡
重	𡍴
野	埜 𡐨
量	量 𨤦 𨤥
釐	𨤺 厘
金	钅 𨤾 𨥄 釒
釒	金 钅
釓	钆
釔	钇
釕	钌
釖	劍
釗	钊
釘	钉
釙	钋
釜	釡
針	箴 鍼 针
釡	釜
釣	钓
釤	钐
釧	钏
釩	钒
釬	銲
釵	叉 钗
釷	钍
釹	钕
釺	钎
釼	劍
鈀	耙 钯
鈁	钫
鈃	钘
鈄	钭
鈆	鉛
鈈	钚
鈉	钠
鈍	钝
鈎	鉤 钩
鈐	𨥩 钤
鈑	钣
鈒	钑
鈔	钞
鈕	㺲 钮
鈞	銞 銁 钧
鈡	鍾
鈣	钙
鈥	钬
鈦	钛
鈧	钪
鈬	鐸
鈮	铌
鈰	铈
鈳	钶
鈴	鈴 铃
鈷	钴
鈸	钹
鈹	铍
鈺	钰
鈽	钸
鈾	铀
鈿	钿
鉀	钾
鉄	紩 鐵 銕
鉅	巨 钜
鉆	鑽 鉗
鉈	砣 𥓿 铊
鉉	铉
鉋	刨 铇
鉍	铋
鉏	鋤
鉑	铂
鉕	钷
鉗	箝 鉆 钳
鉚	铆
鉛	鈆 铅
鉞	戉 钺
鉢	缽 钵
鉤	鈎 钩
鉦	钲
鉬	钼
鉭	钽
鉱	礦
鉴	鑒
鉶	铏
鉸	铰
鉺	铒
鉻	铬
鉾	矛
鉿	铪
銀	银
銁	鈞
銃	铳
銅	铜
銍	铚
銑	铣
銓	铨
銕	鐵 鉄
銖	铢
銘	铭
銚	铫
銛	铦
銜	㘅 衔
銞	鈞
銠	铑
銣	铷
銥	铱
銦	铟
銨	铵
銩	铥
銪	铕
銫	铯
銬	铐
銭	錢
銮	鑾
銱	铞
銲	釬
銳	鋭 锐
銷	销
銹	鏽 锈
銻	厗 锑
銼	剉 锉
鋁	铝
鋂	萌
鋃	锒
鋄	錽
鋅	锌
鋇	钡
鋌	铤
鋏	铗
鋑	鐫 鑴
鋒	锋
鋙	铻
鋝	𨫏 锊
鋟	锓
鋣	铘
鋤	鉏 锄
鋥	锃
鋦	𨦴 锔
鋨	锇
鋩	铓
鋪	舖 铺
鋭	銳 锐
鋮	铖
鋯	锆
鋰	锂
鋱	铽
鋳	鑄
鋶	锍
鋸	锯
鋼	钢
錁	锞
錄	録 录
錆	锖
錇	锫
錈	锩
錏	铔
錐	锥
錒	锕
錕	锟
錘	鎚 锤
錙	锱
錚	铮
錛	锛
錟	锬
錠	锭
錡	锜
錢	钱
錦	锦
錨	锚
錩	锠
錫	㒪 锡
錬	煉
錮	锢
錯	䥘 错
錱	珍
録	錄 录
錳	锰
錶	表
錸	铼
錽	鋄
錾	鏨
鍀	锝
鍁	锨
鍃	锪
鍆	钔
鍇	锴
鍈	锳
鍉	匙
鍊	鍊
鍋	锅
鍍	镀
鍔	锷
鍘	铡
鍚	钖
鍛	煅 锻
鍜	煆
鍠	锽
鍤	锸
鍥	锲
鍩	锘
鍫	鍬
鍬	鍫 锹
鍰	鐶 锾
鍵	键
鍶	锶
鍺	锗
鍼	箴 針
鍾	钟 锺
鎂	镁
鎄	锿
鎇	镅
鎊	镑
鎋	轄
鎌	鐮
鎏	鏐
鎒	耨
鎔	熔 镕
鎖	鏁 鎻 锁
鎘	镉
鎙	槊
鎚	錘 锤
鎛	镈
鎜	盤
鎝	𨱏
鎡	镃
鎢	钨
鎣	蓥
鎦	劉 镏
鎧	铠
鎩	铩
鎪	锼
鎬	镐
鎭	鎮 𨦸
鎮	镇
鎰	镒
鎲	镋
鎳	镍
鎵	镓
鎸	镌
鎻	鎖
鎿	镎
鏁	鎖
鏃	镞
鏇	镟
鏈	链
鏌	镆
鏍	镙
鏐	鎏 镠
鏑	镝
鏗	铿
鏘	𢐓 锵
鏜	镗
鏝	镘
鏞	镛
鏟	剗 铲
鏡	镜
鏢	鑣 镖
鏤	镂
鏥	銹 鏽
鏨	錾
鏰	斆 镚
鏵	铧
鏷	镤
鏹	镪
鏽	銹 锈
鏾	𠜎
鐀	匱 櫃
鐃	铙
鐋	铴
鐐	镣
鐒	铹
鐓	镦
鐔	镡
鐘	鍾 钟
鐙	镫
鐝	镢
鐠	镨
鐡	鐵
鐦	锎
鐧	锏
鐨	镄
鐫	鋑 鑴 镌
鐮	鎌 镰
鐲	镯
鐳	镭
鐵	鉄 銕 䥫 铁
鐶	鍰 镮
鐸	鈬 铎
鐺	铛
鐿	镱
鑄	𤎧 铸
鑊	镬
鑌	镔
鑑	鑒
鑒	鑑 鉴
鑔	镲
鑕	锧
鑚	鑽
鑛	礦 𨥥
鑞	镴
鑠	铄
鑢	䥨
鑣	鏢 镳
鑥	镥
鑭	镧
鑰	钥
鑱	镵
鑲	镶
鑴	鋑 鐫
鑵	罐
鑷	镊
鑹	镩
鑼	锣
鑽	鉆 鑚 钻
鑾	銮
鑿	𨰒 凿
钁	镢
钂	镋
钅	金 釒
钆	釓
钇	釔
针	針
钉	釘
钊	釗
钋	釙
钌	釕
钍	釷
钎	釺
钏	釧
钐	釤
钑	鈒
钒	釩
钓	釣
钔	鍆
钕	釹
钖	锡 鍚
钗	釵
钘	鈃
钙	鈣
钚	鈈
钛	鈦
钜	巨 鉅
钝	鈍
钞	鈔
钟	鍾 鐘
钠	鈉
钡	鋇
钢	鋼
钣	鈑
钤	鈐
钥	鑰
钦	欽
钧	鈞
钨	鎢
钩	鉤 鈎
钪	鈧
钫	鈁
钬	鈥
钭	鈄
钮	鈕
钯	鈀
钰	鈺
钱	錢
钲	鉦
钳	箝 鉗
钴	鈷
钵	缽 鉢
钶	鈳
钷	鉕
钸	鈽
钹	鈸
钺	鉞
钻	鑽
钼	鉬
钽	鉭
钾	鉀
钿	鈿
铀	鈾
铁	鐵
铂	鉑
铃	鈴
铄	鑠
铅	鉛
铆	鉚
铇	鉋
铈	鈰
铉	鉉
铊	鉈
铋	鉍
铌	鈮
铍	鈹
铎	鐸
铏	鉶
铐	銬
铑	銠
铒	鉺
铓	鋩
铔	錏
铕	銪
铖	鋮
铗	鋏
铘	鋣
铙	鐃
铚	銍
铛	鐺
铜	銅
铝	鋁
铞	銱
铟	銦
铠	鎧
铡	鍘
铢	銖
铣	銑
铤	鋌
铥	銩
铦	銛
铧	鏵
铨	銓
铩	鎩
铪	鉿
铫	銚
铬	鉻
铭	銘
铮	錚
铯	銫
铰	鉸
铱	銥
铲	鏟
铳	銃
铴	鐋
铵	銨
银	銀
铷	銣
铸	鑄
铹	鐒
铺	鋪
铻	鋙
铼	錸
铽	鋱
链	鏈
铿	鏗
销	銷
锁	鎖
锂	鋰
锃	鋥
锄	鋤
锅	鍋
锆	鋯
锇	鋨
锈	鏽 銹
锉	銼
锊	鋝
锋	鋒
锌	鋅
锍	鋶
锎	鐦
锏	鐧
锐	銳 鋭
锑	銻
锒	鋃
锓	鋟
锔	鋦
锕	錒
锖	錆
锗	鍺
锘	鍩
错	錯
锚	錨
锛	錛
锜	錡
锝	鍀
锞	錁
锟	錕
锠	錩
锡	錫
锢	錮
锣	鑼
锤	錘 鎚
锥	錐
锦	錦
锧	鑕
锨	杴 鍁
锩	錈
锪	鍃
锫	錇
锬	錟
锭	錠
键	鍵
锯	鋸
锰	錳
锱	錙
锲	鍥
锳	鍈
锴	鍇
锵	鏘
锶	鍶
锷	鍔
锸	鍤
锹	鍬
锺	鍾
锻	鍛
锼	鎪
锽	鍠
锾	鍰
锿	鎄
镀	鍍
镁	鎂
镂	鏤
镃	鎡
镄	鐨
镅	鎇
镆	鏌
镇	鎮
镈	鎛
镉	鎘
镊	鑷
镋	钂 鎲
镌	鎸 鐫
镍	鎳
镎	鎿
镏	鎦
镐	鎬
镑	鎊
镒	鎰
镓	鎵
镔	鑌
镕	鎔
镖	鏢
镗	鏜
镘	鏝
镙	鏍
镚	錋 鏰
镛	鏞
镜	鏡
镝	鏑
镞	鏃
镟	鏇
镠	鏐
镡	鐔
镢	鐝 钁
镣	鐐
镤	鏷
镥	鑥
镦	鐓
镧	鑭
镨	鐠
镩	鑹
镪	鏹
镫	鐙
镬	鑊
镭	鐳
镮	鐶
镯	鐲
镰	鐮
镱	鐿
镲	鑔
镳	鑣
镴	鑞
镵	鑱
镶	鑲
長	镸 𨱗 𠤐 𠑷 𠔊 𠑻 𠑿 𡕣 长
镸	長
长	長
門	门
閂	闩
閃	闪
閆	閻 闫
閇	閉
閈	闬
閉	閇 闭
開	𨴂 𨵑 开
閌	闶
閎	闳
閏	𥹿 闰
閑	闲
閒	𨳡 𨳢 間
間	閒 间
閔	闵
閘	闸
閙	鬧
閡	阂
関	關 闗 𨶹
閣	阁
閤	合
閥	阀
閧	哄 鬨
閨	闺
閩	闽
閫	阃
閬	阆
閭	閭 闾
閱	閲 阅
閲	閱 阅
閵	𨶄
閶	阊
閹	剦 阉
閻	閆 阎
閼	阏
閽	阍
閾	𨵨 阈
閿	阌
闃	阒
闆	板
闇	暗
闈	闱
闊	濶 阔
闋	阕
闌	阑
闍	阇
闐	阗
闒	阘
闓	闿
闔	閤 阖
闕	阙
闖	闯
闗	關 関
闘	鬥
關	寡 関 闗 关
闞	阚
闠	阓
闡	阐
闢	𨴔
闤	阛
闥	闼
门	門
闩	閂
闪	閃
闫	閻 閆
闬	閈
闭	閉
问	問
闯	闖
闰	閏
闱	闈
闲	閑
闳	閎
间	間
闵	閔
闶	閌
闷	悶
闸	閘
闹	鬧
闺	閨
闻	聞
闼	闥
闽	閩
闾	閭
闿	闓
阀	閥
阁	閣
阂	閡
阃	閫
阄	鬮
阅	閱 閲
阆	閬
阇	闍
阈	閾
阉	閹
阊	閶
阋	鬩
阌	閿
阍	閽
阎	閻
阏	閼
阐	闡
阑	闌
阒	闃
阓	闠
阔	闊
阕	闋
阖	閤 闔
阗	闐
阘	闒
阙	闕
阚	闞
阛	闤
阜	阝 𠻰
阝	邑 阜
队	隊
阡	仟
阧	陡
阨	厄 阸 呃
阪	坂
阬	坑
阮	阮
阯	址
阱	穽 汬
阳	氜 陽
阴	陰
阵	陣
阶	階
阸	阨
阾	嶺
阿	啊
陀	陁
陁	陀
际	際
陆	陸
陇	隴
陈	陳
陉	陘
陋	陋
降	降 夅
陏	隋
陔	垓
陕	陝
陗	峭
陘	陉
陜	陝 𩂘 狹
陝	陜 陕
陞	升
陟	𠌹
陡	阧
陣	𨸬 陳 阵
陥	陷
陧	隉
陨	隕
险	險
陰	阴 隂 霒 侌 𤽎 𨽙 𠊺 瘖
陳	𨸬 軙 敶 陣 陈
陵	陵 夌 𨻪 䧙
陶	匋
陷	陥
陸	𤱒 六 陆
険	險
陻	垔 堙
陼	渚
陽	昜 氜 阳 𨼘 𨽐 𣆄
隂	陰
隄	堤 䧑
隆	隆
隈	渨 偎
隉	陧
隊	队
隋	陏
隍	堭
階	堦 阶
随	隨
隐	隠 隱
隕	殒 磒 陨
隖	塢 𨻑
隙	隟
際	际
隝	塢
隟	隙
隠	隱 隐
隣	鄰
隤	墤
隧	𡑞 𨽡
隨	𨼕 遀 追 随
隩	𡒃
險	险
隮	躋
隰	𨻿
隱	𤔌 乚 隐
隲	騭
隴	陇
隶	隸
隷	隸
隸	隷 隶
隻	只
隼	鶽 鵻
隽	雋
难	難
雁	鳫 鴈
雄	赨
集	雦 亼
雇	僱
雉	𨿘 𪁩
雋	隽
雌	䧳
雍	邕
雏	雛
雑	雜
雕	㓮 彫 鵰
雖	𨾡 虽
雙	双
雛	鶵 雏
雜	雑 襍 杂
雝	廱
雞	鷄 鳮 鸡
雠	仇 讎
離	離 离
難	𩁢 𩁬 𩀙 𩁣 𩁲 𩁩 𩀏 𩁤 难
雦	集
雨	𠕒 𠕘 𠕲 𩁼 㲾 馭
雱	霶
雲	云
雳	靂
零	零 𡈍
雷	雷 𤴐 𩂩 𩇓 𤳳 䨓 𩄣 靁 㗊 𤴑
雹	𩅟 𩆗 𩇌
電	𩃿 电
雾	霧
需	𩂉
霁	霽
震	𩆉
霊	靈
霍	癨
霏	䬠
霒	陰
霛	靈
霜	孀
霡	霢
霢	霡
霣	𩆆 𩆹
霥	濛
霧	雾
霭	靄
霰	𩂪 䨘
露	露
霶	雱
霸	覇 魄 𣍸
霽	霁
靀	濛
靁	雷
靂	雳
靄	霭
靆	叇
靈	靈 霛 𩆮 𧨈 𩄀 𢩙 灵
靉	叆
靑	青 𡴑 𡴏 𡴐 𡗡 寈
青	靑
靓	靚
靔	靝
靖	靖
静	靜
靚	靜 靓
靜	㣏 静
靝	靔 天
靡	𪎓
面	麵
靥	靨
靦	覥 腼 䩄
靧	頮
靨	靥
革	𠦶
靭	韌
靱	韌
靴	鞾
靼	𩍕
鞀	鼗 鞉
鞈	䶀
鞉	鞀 鼗
鞋	鞵 𩋘 𩋧
鞌	鞍
鞍	鞌
鞏	巩
鞑	韃
鞒	橇 鞽
鞘	韒
鞙	琄
鞝	绱
鞟	鞹
鞠	𠮑
鞦	鞧
鞧	鞦
鞫	諊
鞭	𠓠
鞯	韉
鞲	韝
鞴	絥
鞵	鞋
鞶	𣎤
鞹	𩌒 鞟
鞽	橇 鞒
鞾	靴
韁	繮 缰
韂	䩞
韃	鞑
韈	襪 韤
韉	鞯
韋	𣍄 𡙝 𡚈 韦
韌	肕 靭 韧
韍	韨
韎	𣝖
韒	鞘
韓	韩
韙	韪
韜	弢 韬
韝	鞲
韞	縕 韫
韤	襪 韈
韦	韋
韧	韌
韨	韍
韩	韓
韪	韙
韫	韞
韬	韜
韭	艽 韮
韮	韭
韲	齏
韵	韻
韶	𢨍
韻	均 韵
響	𡪥 𡪆 响
頁	页
頂	𩠑 顶
頃	頔 顷
項	项
順	㥧 巡 𠈼 顺
頇	顸
須	湏 须
頊	顼
頋	顧
頌	颂
頎	颀
頏	颃
預	豫 预
頑	顽
頒	朌 颁
頓	顿
頔	頃
頗	颇
領	領 领
頚	頸
頜	颌
頟	額
頡	颉
頣	頤
頤	頉 頣 颐
頦	颏
頫	俯
頬	頰
頭	𥘖 头
頮	靧 颒
頰	颊
頲	颋
頴	穎 颕
頷	颔
頸	颈
頹	頽 颓
頻	𩔤 频
頼	賴
頽	頹 颓
顆	颗
顋	腮
題	题
額	頟 额
顎	颚
顏	颜
顒	颙
顓	颛
顔	顏 颜
顕	顯
顖	囟
願	愿 𩕾
顙	颡
顚	顛
顛	颠
類	類 𩔗 类
顢	颟
顥	皓 皝 颢
顦	憔
顧	頋 𪄮 顾
顫	颤
顬	颥
顯	顕 㬎 显
顰	嚬 颦
顱	髗 颅
顳	颞
顴	颧
页	頁
顶	頂
顷	頃
顸	頇
项	項
顺	順
须	須 鬚
顼	頊
顽	頑
顾	顧
顿	頓
颀	頎
颁	頒
颂	頌
颃	頏
预	預
颅	顱
领	領
颇	頗
颈	頸
颉	頡
颊	頰
颋	頲
颌	頜
颍	潁
颎	熲
颏	頦
颐	頤
频	頻
颒	頮
颓	頹 頽
颔	頷
颕	頴
颖	穎
颗	顆
题	題
颙	顒
颚	顎
颛	顓
颜	顏 顔
额	額
颞	顳
颟	顢
颠	顛
颡	顙
颢	顥
颣	纇
颤	顫
颥	顬
颦	顰
颧	顴
風	𠙊 𠙈 凬 飌 檒 风
颭	飐
颮	猋 飇 飑
颯	飒
颱	台
颳	刮
颶	飓
颸	飔
颺	飏
颻	飖
颼	䬒 飕
飀	飗
飄	飃 飘
飆	飙
飇	猋 颮
飈	飚
飌	風
风	風
飏	颺
飐	颭
飑	颮
飒	颯
飓	颶
飔	颸
飕	颼
飖	颻
飗	飀
飘	飄
飙	飆
飚	飈
飛	𩙱 𦐭 飞
飜	翻
飞	飛
食	饣 飠 𩚃 餐
飠	食 饣
飡	餐
飢	饑 饥
飣	饤
飤	飼
飥	饦
飦	饘
飨	饗
飩	饨
飪	餁 䏕 𦜙 饪
飫	饇 秗 饫
飭	饬
飮	飲 𣲎 𩚜 淾 𣶗 㱃 𩚕 𨡳
飯	饭
飰	飯
飲	飮 饮
飴	䬮 饴
飼	飼 飤 饲
飽	𩜿 𩜕 𩛞 饱
飾	餙 饰
飿	饳
餁	飪
餂	舔 甛
餃	饺
餄	饸
餅	餠 饼
餉	饟 𩜋 饷
養	䍩 𢼝 养
餌	饵
餍	饜
餎	饹
餏	饻
餐	食 飡
餑	饽
餒	餧 馁
餓	饿
餕	馂
餖	饾
餘	馀 余
餙	飾
餚	肴
餛	餫 馄
餜	䴹 馃
餝	飾
餞	饯
餟	醊
餠	餅
餡	馅
餧	喂 餒
館	館 舘 馆
餫	餛
餱	糇
餳	饧
餵	諉 喂
餶	馉
餷	馇
餹	糖
餺	馎
餻	糕
餼	饩
餽	饋
餾	馏
餿	馊
饁	馌
饃	馍
饅	馒
饇	飫
饈	𦟤 馐
饉	馑
饊	糤 馓
饋	餽 匱 櫃 𠩸 馈
饌	䉵 籑 馔
饍	膳
饐	䬥
饑	飢 𩜆 𩚮 饥
饒	饶
饕	叨
饗	飨
饘	飦
饜	餍
饞	嚵 馋
饟	餉
饡	𩛻 䬤
饢	馕
饣	飠
饤	飣
饥	飢 饑
饦	飥
饧	餳
饨	飩
饩	餼
饪	飪
饫	飫
饬	飭
饭	飯
饮	飮 飲
饯	餞
饰	飾
饱	飽
饲	飼
饳	飿
饴	飴
饵	餌
饶	饒
饷	餉
饸	餄
饹	餎
饺	餃
饻	餏
饼	餅
饽	餑
饾	餖
饿	餓
馀	餘 余
馁	餒
馂	餕
馃	餜
馄	餛
馅	餡
馆	館
馇	餷
馈	餽 饋
馉	餶
馊	餿
馋	饞
馌	饁
馍	饃
馎	餺
馏	餾
馐	饈
馑	饉
馒	饅
馓	糤 饊
馔	饌
馕	饢
首	𩠐 𥃻
馘	聝
香	㿝
馚	馩
馧	蒀
馩	馚
馬	𢒠 𩡬 𢒗 马
馭	御 驭
馮	淜 冯
馱	駄 䭾 驮
馳	𧂓 驰
馴	訓 驯
馹	驲
馿	驢
駁	駮 驳
駄	馱
駅	驛
駆	驅
駈	驅
駐	驻
駑	驽
駒	驹
駔	驵
駕	𩢟 驾
駘	骀
駙	驸
駛	𩢲 驶
駝	驼
駞	駝
駟	驷
駡	罵 骂
駢	騈 骈
駦	騰
駪	侁 詵
駭	骇
駮	駁
駰	骃
駱	駱 骆
駸	骎
駿	骏
騁	𩧢 骋
騂	骍
騃	呆
騅	骓
騈	駢
騌	鬃 騣 骔
騍	骒
騎	骑
騏	䭼 䭶 骐
騐	驗
騒	騷
験	驗
騖	骛
騗	騙
騘	驄
騙	騗 骗
騣	鬃 騌
騤	骙
騧	䯄
騨	驒
騫	骞
騭	隲 骘
騮	骝
騰	駦 腾
騶	驺
騷	骚
騸	骟
騺	驇
騾	驘 骡
驀	蓦
驁	骜
驂	骖
驃	骠
驄	騘 骢
驅	敺 驱
驇	騺
驊	𦽊 骅
驌	骕
驍	骁
驏	骣
驒	騨
驕	骄
驗	騐 验
驘	騾
驚	惊
驛	驿
驟	骤
驢	馿 驴
驤	骧
驥	蘎 骥
驦	骦
驩	歡
驪	骊
驫	骉
马	馬
驭	馭
驮	馱
驯	馴
驰	馳
驱	驅
驲	馹
驳	駁
驴	驢
驵	駔
驶	駛
驷	駟
驸	駙
驹	駒
驺	騶
驻	駐
驼	駝
驽	駑
驾	駕
驿	驛
骀	駘
骁	驍
骂	罵 駡
骃	駰
骄	驕
骅	驊
骆	駱
骇	駭
骈	駢
骉	驫
骊	驪
骋	騁
验	驗
骍	騂
骎	駸
骏	駿
骐	騏
骑	騎
骒	騍
骓	騅
骔	鬃 騌
骕	驌
骖	驂
骗	騙
骘	騭
骙	騤
骚	騷
骛	騖
骜	驁
骝	騮
骞	騫
骟	騸
骠	驃
骡	騾
骢	驄
骣	驏
骤	驟
骥	驥
骦	驦
骧	驤
骫	骪
骯	腌 肮
骴	胔 𦙼
骵	體
骻	胯
骽	腿
骾	挭 鯁
髃	腢
髄	髓
髅	髏
髋	髖
髌	臏 髕
髏	髅
髒	脏
髓	膸
體	𩪆 体
髕	臏 髌
髖	髋
髗	臚 顱
高	髙
髙	高
髣	仿 彷
髦	犛
髪	髮
髮	𩠖 𩑛 𩑱 𤕥 发
髯	髥
髴	彿
髻	䯻
髼	鬅
鬀	剃
鬂	鬢
鬃	骔
鬅	髼
鬆	松
鬊	𡿦
鬍	胡
鬒	㐱
鬓	𩯭 鬢
鬚	须
鬢	鬂 鬓
鬣	巤
鬥	鬬 鬭 鬦 鬪 斗
鬦	鬥
鬧	閙 闹
鬨	哄 閧
鬩	阋
鬪	鬥 鬬
鬬	鬥 鬪
鬭	鬥
鬮	䰗 阄
鬰	鬱
鬱	鬰 𦉚 欝 郁
鬲	䰜
鬵	𩱠
鬶	鬹
鬹	鬶
鬻	粥
鬼	𩲡 𢇼 𣆠
魁	𩲔
魄	霸
魅	𢑘
魇	魘
魉	魎
魎	魉
魏	巍
魑	𩳩
魘	魇
魙	聻
魚	𤉯 鱼
魛	鱽
魟	鰩
魢	鱾
魦	鯊
魨	鲀
魯	魯 𣥐 旅 鲁
魴	鲂
魷	鰌 鱿
魺	鲄
鮁	鲅
鮃	鲆
鮊	鲌
鮋	鲉
鮍	鲏
鮎	鲇
鮐	鲐
鮑	鲍
鮒	鲋
鮓	鲊
鮚	鲒
鮜	鲘
鮝	鯗 鲞
鮞	鲕
鮦	鲖
鮧	鯷
鮨	䱈
鮪	鲔
鮫	鲛
鮭	鲑
鮮	尟 鱻 鲜
鮳	鲓
鮶	鲪
鮺	鲝
鯀	鲧
鯁	挭 骾 鲠
鯇	鲩
鯉	鲤
鯊	魦 鲨
鯋	鯊
鯒	鲬
鯔	鲻
鯕	鲯
鯖	鲭
鯗	鮝 鲞
鯛	鲷
鯝	鲴
鯡	鲱
鯢	鲵
鯤	鲲
鯧	䱽 鲳
鯨	鲸
鯪	鲮
鯫	鲰
鯰	鲇 鲶
鯴	鲺
鯷	鮧 鳀
鯽	鲫
鯿	鳊
鰁	鳈
鰂	鲗
鰃	鳂
鰈	鲽
鰉	鱑 鳇
鰌	鰍 魷
鰍	鰌 鳅
鰏	鲾
鰐	鱷 鳄
鰒	鳆
鰓	鳃
鰕	蝦
鰛	鳁
鰜	鳒
鰟	鳑
鰠	鳋
鰣	鲥
鰥	𩶊 鳏
鰨	鳎
鰩	魟 鳐
鰭	鳍
鰮	鳁
鰱	鲢
鰲	鼇 鳌
鰳	鳓
鰵	鳘
鰷	鲦
鰹	鲣
鰺	鲹
鰻	鳗
鰼	鳛
鰾	鳔
鱂	鳉
鱅	鳙
鱈	鳕
鱉	龞 鼈 鳖
鱑	鰉
鱒	鳟
鱓	鱔 䱇
鱔	鱓 鳝
鱖	鳜
鱗	鱗 鳞
鱘	鲟
鱝	鲼
鱟	鲎
鱠	膾 鲙
鱣	鳣
鱤	鳡
鱧	鳢
鱨	鲿
鱭	鲚
鱯	鳠
鱷	鰐 鳄
鱸	鲈
鱺	鲡
鱻	鮮
鱼	魚
鱽	魛
鱾	魢
鱿	魷
鲀	魨
鲁	魯
鲂	魴
鲃	䰾
鲄	魺
鲅	鮁
鲆	鮃
鲇	鮎 鯰
鲈	鱸
鲉	鮋
鲊	鮓
鲋	鮒
鲌	鮊
鲍	鮑
鲎	鱟
鲏	鮍
鲐	鮐
鲑	鮭
鲒	鮚
鲓	鮳
鲔	鮪
鲕	鮞
鲖	鮦
鲗	鰂
鲘	鮜
鲙	鱠
鲚	鱭
鲛	鮫
鲜	鮮
鲝	鮺
鲞	鮝 鯗
鲟	鱘
鲠	鯁
鲡	鱺
鲢	鰱
鲣	鰹
鲤	鯉
鲥	鰣
鲦	鰷
鲧	鯀
鲨	鯊
鲩	鯇
鲪	鮶
鲫	鯽
鲬	鯒
鲭	鯖
鲮	鯪
鲯	鯕
鲰	鯫
鲱	鯡
鲲	鯤
鲳	鯧
鲴	鯝
鲵	鯢
鲶	鯰
鲷	鯛
鲸	鯨
鲹	鰺
鲺	鯴
鲻	鯔
鲼	鱝
鲽	鰈
鲾	鰏
鲿	鱨
鳀	鯷
鳁	鰛 鰮
鳂	鰃
鳃	鰓
鳄	鰐 鱷
鳅	鰍
鳆	鰒
鳇	鰉
鳈	鰁
鳉	鱂
鳊	鯿
鳋	鰠
鳌	鰲
鳍	鰭
鳎	鰨
鳏	鰥
鳐	鰩
鳑	鰟
鳒	鰜
鳓	鰳
鳔	鰾
鳕	鱈
鳖	鱉
鳗	鰻
鳘	鰵
鳙	鱅
鳚	䲁
鳛	鰼
鳜	鱖
鳝	鱔
鳞	鱗
鳟	鱒
鳠	鱯
鳡	鱤
鳢	鱧
鳣	鱣
鳥	鸟
鳧	凫
鳩	鸠
鳫	雁
鳬	凫
鳮	雞 鷄
鳯	鳳
鳲	鸤
鳳	鳯 𠤈 𧱶 𪆍 鴌 凤
鳴	鸣
鳶	鸢
鳽	鸇
鳾	䴓
鴃	鵙
鴄	裒
鴆	酖 鸩
鴇	鸨
鴈	雁 𩾦
鴉	鵶 鸦
鴌	鳳
鴎	鷗
鴒	鸰
鴕	鸵
鴛	鸳
鴝	𪁖 𩿩 朐 鸜 鸲
鴞	梟 鸮
鴟	鸱
鴣	鸪
鴦	鸯
鴨	鵪 𪁨 鸭
鴬	鶯
鴯	鸸
鴰	鸹
鴳	鷃
鴴	鸻
鴷	䴕
鴺	鵜
鴻	䲨 鸿
鴿	鸽
鵁	䴔
鵂	鸺
鵃	鸼
鵉	鸞
鵐	鹀
鵑	鹃
鵒	鹆
鵓	鹁
鵙	鴃
鵜	鴺 鹈
鵝	䳗 鵞 鹅
鵞	鵝
鵠	鹄
鵡	鹉
鵪	鴨 鹌
鵬	鹏
鵮	鹐
鵯	鹎
鵰	彫 雕
鵲	鹊
鵷	鹓
鵻	隼
鵾	鹍
鶂	鶃
鶃	鶂
鶄	䴖
鶇	鸫
鶉	鹑
鶊	鹒
鶏	雞
鶓	鹋
鶖	鹙
鶘	鹕
鶚	鹗
鶡	鹖
鶥	鹛
鶩	鹜
鶪	䴗
鶬	鸧
鶯	鸎 莺
鶲	鹟
鶴	鹤
鶵	雛
鶹	鹠
鶺	鹡
鶻	鹘
鶼	鹣
鶽	隼
鶿	鹚
鷀	鹚
鷁	鹢
鷂	鹞
鷃	鴳
鷄	雞 鳮 鸡
鷈	䴘
鷊	鹝
鷏	鷆
鷓	鹧
鷖	鹥
鷗	鸥
鷙	鸷
鷚	鹨
鷥	鸶
鷦	鹪
鷩	氅
鷫	鹔
鷯	鹩
鷰	燕
鷲	鹫
鷳	鹇
鷸	鹬
鷹	鹰
鷺	鷺 鹭
鷽	鸴
鷿	䴙
鸂	㶉
鸇	鳽 𪄃 鹯
鸌	鹱
鸎	鶯
鸏	鹲
鸕	鸬
鸘	鹴
鸚	鹦
鸛	鹳
鸜	朐 鴝
鸝	鹂
鸞	鸾
鸟	鳥
鸠	鳩
鸡	雞 鷄
鸢	鳶
鸣	鳴
鸤	鳲
鸥	鷗
鸦	鴉
鸧	鶬
鸨	鴇
鸩	鴆
鸪	鴣
鸫	鶇
鸬	鸕
鸭	鴨
鸮	鴞
鸯	鴦
鸰	鴒
鸱	鴟
鸲	鴝
鸳	鴛
鸴	鷽
鸵	鴕
鸶	鷥
鸷	鷙
鸸	鴯
鸹	鴰
鸺	鵂
鸻	鴴
鸼	鵃
鸽	鴿
鸾	鸞
鸿	鴻
鹀	鵐
鹁	鵓
鹂	鸝
鹃	鵑
鹄	鵠
鹅	鵝
鹆	鵒
鹇	鷳
鹈	鵜
鹉	鵡
鹊	鵲
鹋	鶓
鹌	鵪
鹍	鵾
鹎	鵯
鹏	鵬
鹐	鵮
鹑	鶉
鹒	鶊
鹓	鵷
鹔	鷫
鹕	鶘
鹖	鶡
鹗	鶚
鹘	鶻
鹙	鶖
鹚	鶿 鷀
鹛	鶥
鹜	鶩
鹝	鷊
鹞	鷂
鹟	鶲
鹠	鶹
鹡	鶺
鹢	鷁
鹣	鶼
鹤	鶴
鹥	鷖
鹦	鸚
鹧	鷓
鹨	鷚
鹩	鷯
鹪	鷦
鹫	鷲
鹬	鷸
鹭	鷺
鹯	鸇
鹰	鷹
鹱	鸌
鹲	鸏
鹳	鸛
鹴	鸘
鹵	卤
鹸	鹼
鹹	咸
鹺	鹾
鹻	堿 碱 鹼
鹼	硷 堿 碱 鹻
鹽	䀋 塩 𥂁 盐
鹾	鹺
鹿	鹿
麀	𪋎
麁	粗
麄	粗 觕 麤
麇	麕
麐	麟
麓	梺 㯟
麕	麇
麗	𠧥 𠀙 麗 𪋘 丽
麞	獐
麟	麟 麐
麤	粗 觕 麄
麥	麦
麦	麥
麩	麸
麪	麵
麫	麵
麯	麴
麰	牟
麴	麹 𥶶 麯
麵	麺 麪 麫 面
麸	麩
麺	麵
麻	菻 蔴
麼	麽 尛 庅 么
麽	麼 庅 么
黀	𪎪
黃	𡕛 黄
黄	黃
黉	黌
黌	黉
黎	黎
黏	粘
黑	黒
黒	黑
黔	𦌣
默	黙 嘿
黙	默
點	奌 点
黡	黶
黥	䵞
黨	党
黩	黷
黪	黲
黲	黪
黶	黡
黷	黩
黽	黾
黾	黽
黿	鼋
鼂	鼌 𪓨 𪓲
鼃	蛙
鼄	蛛
鼅	蜘
鼇	鰲
鼈	鱉
鼉	鼍
鼋	黿
鼌	鼂
鼍	鼉
鼎	鼑 𪔂
鼏	冪 幂
鼑	鼎
鼓	皼 𩉲 皷 鼔
鼔	皷 鼓
鼕	冬
鼗	鞀 鞉
鼠	鼡
鼡	鼠
鼦	貂
鼴	鼹
鼹	鼴
鼻	自
齁	𪖙
齅	嗅
齊	亝 斉 斋 齋 齐
齋	斎 斋 齊
齎	賫 赍
齏	韲 齑
齐	齊
齑	齏
齒	歯 𠚒 𠔒 𦥒 𣥫 𦥪 齿
齔	龀
齕	龁
齗	龂
齙	龅
齜	龇
齟	龃
齠	龆
齡	齢 龄
齢	齡
齦	啃 龈
齧	嚙 囓
齩	咬
齪	龊
齬	龉
齲	龋
齶	腭
齷	龌
齹	𪙐
齿	齒
龀	齔
龁	齕
龂	齗
龃	齟
龄	齡
龅	齙
龆	齠
龇	齜
龈	齦
龉	齬
龊	齪
龋	齲
龌	齷
龍	竜 𦱉 𢅛 𠊋 㰍 𥫈 龒 䰱 龙
龎	龐 厐
龐	厐 龎 庞
龒	龍
龓	䪊
龔	龚
龕	龛
龗	𩆇 𪚙 𩆈
龙	龍
龚	龔
龛	龕
龜	𠃾 𠁴 𤕣 龟
龝	䆋 秋
龟	龜
龠	籥
龡	吹
龢	和 咊
龤	諧
龥	籲
㐀	丘
㐁	𠀬
㐅	五
㐫	凶
㐮	襄
㐯	庸
㐰	信
㐱	鬒
㐴	攀
㑁	𠭴
㑄	侮
㑌	尩
㑝	𢙱
㑩	儸
㒇	儛
㒋	廝 厮
㒌	煢
㒚	穩 文
㒞	儶
㒪	錫
㒰	全
㒲	財
㒳	兩
㒶	公
㒷	興
㓁	网
㓝	𠜚
㓟	披
㓣	割
㓥	劏
㓮	彫 雕
㓷	劓
㓸	斲
㔉	劚
㔍	䥷
㔱	斞
㔲	簋
㔾	卩
㕂	吟
㕑	𢊍 厨
㕕	幻
㕚	爪 爫
㕛	友
㕜	史
㕞	刷
㕣	𧮲
㕬	訟
㖈	䎛
㖊	噚
㖞	喎
㖧	吻
㗊	雷
㗖	啖 噉 啗
㗳	嗒
㘅	銜 啣
㘡	柙
㘳	丘
㘶	桀
㘸	坐
㘽	㦳
㙀	畂
㙐	朵
㙬	垠
㙮	塔
㙳	轗
㙵	臺
㙶	堂
㚆	𠰞
㚔	幸
㚖	澤
㚝	奞 奎
㚢	奴 侮
㚣	姣
㚦	姬
㚶	姒
㛕	姶
㛛	娠
㛟	𡞵
㛠	𡢃
㛽	姍
㛿	𡠹
㜽	子
㝃	娩
㝄	純
㝑	旁
㝒	居
㝙	寅
㝛	宿
㝵	礙 碍
㝿	跛
㞐	居
㞢	之
㞧	會
㞫	走
㞷	呈 𡴍
㞺	族
㟆	㠏
㟗	邠 豳
㟚	岐
㠊	嶇
㠏	㟆
㠪	巨
㠭	展
㠯	以
㠶	帆
㡅	𠕰
㡘	𢅏
㡯	度 宅
㡿	斥
㢏	逾
㢴	西
㢸	弼
㣇	𡱃
㣈	𠮇
㣉	工
㣋	丹
㣏	靜
㣛	會
㣫	動
㣶	邅
㣺	心
㣼	忍
㣽	恕
㤒	笨
㤵	慈
㥃	悶 懣
㥕	憐
㥧	順
㥲	愼
㥵	慁
㥶	𢤑 𢥜
㥸	愍
㦉	㦤
㦛	𢗓
㦤	㦉 㱅
㦧	憯
㦳	㘽
㦻	襲
㦿	戶
㧃	收
㧈	引
㧑	撝
㧖	扼 搤
㧜	擸
㧟	擓
㧨	扏
㨉	抿
㨨	㩅
㨫	㩜
㨼	撂
㩁	搉
㩅	㨨
㩜	攬 擥 㨫
㩠	捊
㩲	拳
㩹	𢶣
㪅	更
㪯	舉
㫃	偃
㫚	昒
㬅	曼
㬎	顯
㬱	朁
㬹	踭
㭃	綱
㭨	椰
㮓	亙 𣍭
㮚	栗
㮣	槩 槪
㮤	松
㮺	本
㯃	漆 桼
㯟	麓
㯭	樐 櫓
㯶	棕
㯽	檳
㰍	櫳 龍
㱃	飮
㱅	㦤
㱏	正 定
㱒	訶
㱛	布
㱩	殰
㱮	殨
㱿	殼 壳
㲒	勽
㲓	毧
㲻	溺
㲾	雨
㲿	瀇
㳄	涎
㳅	流
㴅	消
㴇	涉
㴉	濟
㴑	溯
㴔	潝
㴴	湛
㵄	漢
㵒	沸
㶉	鸂
㶶	燶
㶽	煱
㷉	熨 尉
㷠	燐 粦
㷻	煳
㸒	淫
㸘	萬
㺍	獱
㺜	𤣜
㺲	鈕
㺺	瑁
㻎	瑟
㻏	𤫩
㻘	𤪺
㻫	珌
㼙	甃
㼱	𠬫
㽙	允
㽣	域
㽽	痼
㾄	讟
㾊	瘠
㾙	脪
㿒	𤺜
㿝	香
㿟	皦 皎
㿷	糙
䀋	鹽
䀠	瞿
䀢	瞬
䀹	睫
䁖	瞜
䁞	省
䂀	𥋟
䂐	拙
䂫	夯
䃉	珉
䃘	硜
䃶	𥑋
䄂	𥛅
䄃	殃
䄍	蜡
䄕	社
䄯	𢆞
䄺	稊
䅀	𥟜
䅇	粟
䅉	稏
䆋	龝 秋
䆐	國
䆔	竉
䆫	窓 窗
䇧	箕
䇲	筴
䈇	罩
䉈	𥷭
䉵	饌 籑
䊜	糰
䊷	䌶
䋁	綆
䋙	䌺
䋲	繩
䋻	䌾
䌥	縯
䌫	纜
䌶	䊷
䌷	紬
䌸	縳
䌹	絅
䌺	䋙
䌼	綐
䌽	綵
䌾	䋻
䍀	繿
䍁	繸
䍩	養
䎛	㖈
䎹	聞
䎽	聞
䏋	肅
䏕	䏯 飪
䏯	䏕
䐌	腆
䐰	饈
䑑	僕
䒒	苕
䒬	莫
䒺	菫
䓕	薳
䓠	𦵺
䔛	檾
䔢	華
䕌	稚
䕾	荶
䖈	虐
䖍	虔
䖏	処 處
䖟	蝱
䖣	蚤
䖵	蜫
䗖	螮
䘑	脉
䘚	卒
䘛	𧝞
䘺	綻
䙊	𧜵
䙓	襬
䙝	褻 褺
䙴	𦧂
䙷	得
䚎	𥅾
䚱	信
䛜	訊
䛡	話
䛦	訟
䛻	誘
䛼	譭
䜊	嘈
䜌	𤔪
䜣	訢
䜥	𧩙
䜧	譅
䜭	濬 叡
䜶	豇
䝋	豵
䝙	貙
䝜	狻
䝤	獠
䝼	䞍
䞈	貨
䞌	𧵳
䞍	䝼
䞐	賰
䞓	赬
䞯	𠓗
䟚	踑
䠁	躋
䠱	躅
䢂	𨋢
䢉	農
䢒	交
䢙	敗 𠟻
䢦	帥
䣩	醇
䤇	𨤇
䤍	𨢥
䥀	捵
䥘	錯
䥚	初
䥨	鑢
䥫	鐵
䥷	㔍
䥿	𨯅
䦀	𨦫
䦁	𨧜
䦓	覘 𦕒
䦼	𨼱
䧑	隄
䧕	域
䧙	陵
䧳	雌
䨈	𧵯
䨓	雷
䨘	霰
䩄	靦
䩞	韂
䩭	羈
䪊	龓
䪿	囟
䫃	脣
䬍	𩙤
䬒	颼
䬠	霏
䬡	翥
䬤	饡
䬥	饐
䬮	飴
䭶	騏
䭼	騏
䭾	馱
䯀	䯅
䯃	𩣑
䯄	騧
䯅	䯀
䯌	尻
䯨	敲
䯻	髻
䰗	鬮
䰜	鬲
䰱	龍
䰾	鲃
䱇	鱓
䱈	鮨
䱷	漁
䱽	鯧 䲝
䲁	鳚
䲝	䱽
䲞	𩶘
䲨	鴻
䳗	鵝
䴓	鳾
䴔	鵁
䴕	鴷
䴖	鶄
䴗	鶪
䴘	鷈
䴙	鷿
䴹	餜
䵑	䵒
䵒	䵑
䵞	黥
䵷	蛙
䵺	圢
䶀	鞈
䶏	涕
䶞	𪗞
豈	岂
更	更 㪅
車	𠦴 车
賈	贾
滑	磆
串	串
句	句
龜	𠃾 𠁴 𤕣 龟
龜	𠃾 𠁴 𤕣 龟
契	契
金	钅 𨤾 𨥄 釒
喇	喇
奈	柰
懶	懒
癩	癩 癞
羅	羅 罗
蘿	蘿 萝
螺	螺 蠃
裸	裸 躶 𡑤
邏	邏 逻
樂	樂 乐
洛	洛 洜
烙	烙
珞	珞
落	落
酪	酪
駱	駱 骆
亂	𠧎 𠧏 𠮗 乱
卵	卵
欄	欄 栏
爛	烂
蘭	兰
鸞	鸾
嵐	嵐 岚
濫	滥
藍	蓝
襤	襤 褴
拉	拉
臘	腊 臈
蠟	蜡
廊	廊
朗	朗 𥇑 脼
浪	浪
狼	狼
郎	郞
來	來 来 徠 耒
冷	冷
勞	勞 𠣁 𢥒 劳
擄	擄 虜 掳
櫓	櫓 㯭 樐 艪 橹
爐	爐 炉
盧	卢
老	耂 𠄰
蘆	蘆 芦
虜	虜 擄 虏
路	路
露	露
魯	魯 𣥐 旅 鲁
鷺	鷺 鹭
碌	碌
祿	祿 禄
綠	綠 氯 绿
錄	録 录
鹿	鹿
論	論 论
壟	壟 垄
弄	弄 瘧
籠	籠 笼
聾	聾 聋
牢	牢 𡘠
磊	磊 磥
賂	赂
雷	雷 𤴐 𩂩 𩇓 𤳳 䨓 𩄣 靁 㗊 𤴑
壘	塁 垒
屢	屢 𡜸 屡
樓	樓 楼
淚	淚 泪
漏	漏
累	纍
縷	缕
陋	陋
勒	勒
肋	肋
凜	凛
凌	凌
稜	稜 棱 楞
綾	绫
菱	菱 𧅊
陵	陵 夌 𨻪 䧙
讀	讀 读
拏	拏 拿 挐
樂	樂 乐
諾	喏 诺
丹	丹 𠁿 㣋 𠕑
寧	寍 𡨴 宁
怒	怒 𢘂
率	率 卛
異	異 𢄖 异
北	北 𧉥
磻	磻
便	便
復	覆 𢕛 𠣸 复
不	不 𠀚 𠙐
數	数
索	索
參	參 𠫰 朁 叅 薓 参
塞	塞
省	省 𡮀 䁞
葉	葉 叶
說	説 说
殺	殺 𢁛 𢽅 𢿹 𢽆 𢼡 𢿔 𧤿 杀
辰	辰 𠩟 𠨷 𨑄
沈	沉 瀋
拾	十
若	若 𦱡 𦱶 𧁇
掠	掠
略	畧
亮	亮
兩	両 㒳 两
凉	涼
梁	梁 𣹷 渿 樑
糧	粮
良	良 𡰩 𥭣 𡆨
諒	谅
量	量 𨤦 𨤥
勵	劢 励
呂	呂 吕
女	女 𠨰
廬	廬 庐
旅	旅 𣥏 𣃨 魯 𣥐
濾	濾 滤
礪	礪 砺
閭	閭 闾
驪	骊
麗	𠧥 𠀙 麗 𪋘 丽
黎	黎
力	力 𠠲
曆	𢍷 厤 歴 歷 历
歷	曆 歴 𡿌 历
轢	轢 轹
年	秊 𠫺
憐	憐 㥕 怜
戀	戀 恋 𤕈
撚	撚
漣	涟
煉	煉 炼
璉	琏
秊	秊
練	练
聯	聨 联
輦	輦 𨍻 襜 辇
蓮	苓 莲
連	連 连
鍊	鍊
列	列
劣	劣
咽	咽 嚥
烈	煭
裂	裂
說	説 说
廉	廉 磏 槏 𢋯 𢉧
念	念
捻	捻
殮	殓
簾	簾 𢅖 𢅏 帘
獵	獵 𤢪 猎
令	令
囹	囹
寧	寍 𡨴 宁
嶺	嶺 阾 岭
怜	憐
玲	玲
瑩	瑩 莹
羚	羚
聆	聆
鈴	鈴 铃
零	零 𡈍
靈	靈 霛 𩆮 𧨈 𩄀 𢩙 灵
領	領 领
禮	禮 礼 𠃞 𤔑 礼
醴	醴
隸	隷 隶
惡	惡 亞 恶
了	了
僚	僚
寮	寮
尿	尿 溺
樂	樂 乐
燎	燎
療	疗
蓼	蓼
遼	遼 辽
龍	竜 𦱉 𢅛 𠊋 㰍 𥫈 龒 䰱 龙
暈	晕
阮	阮
劉	鎦 𠭱 刘
柳	檉 丣 𣓠
流	流 㳅
溜	溜
琉	琉 瑠
留	畄 畱
硫	硫
紐	紐 纽
類	類 𩔗 类
六	六 陸
戮	戮 𡠢 𦐱
陸	𤱒 六 陆
倫	倫 伦
崙	崙 侖 崘
淪	沦
輪	輪 轮
律	律
慄	慄 栗
栗	慄 㮚 𣡼 𣡷 慄
率	率 卛
隆	隆
利	利 𥝢 𥝤
吏	吏
履	履 𡲟 𩕎
易	易
李	李 杍
梨	梨 棃
泥	泥 坭
理	理
痢	痢
罹	罹
裏	里 裡 里
裡	裏 里
里	裏 裡
離	離 离
匿	匿
溺	尿 氼 㲻
吝	吝 恡 悋 𠲲 𠯌 𠴽
燐	燐 㷠 粦
璘	璘
藺	蔺
隣	鄰
鱗	鱗 鳞
麟	麟 麐
林	林
淋	淋
臨	臨 𦣷 临
立	立
笠	笠
粒	粒 𩚷
狀	状
炙	炙
識	𧨺 识
什	什
茶	茶
刺	刾 莿
切	切
度	廓 𡧪 㡯
拓	拓 托 摕
糖	糖 餹
宅	宅 𡧪 㡯
洞	峒
暴	暴 𣋴 虣
輻	輻 辐
行	行
降	降 夅
見	见
廓	廓 𢌓
兀	兀
嗀	嗀
塚	塚 中
晴	晴
猪	猪 豬
益	益 𠍳
礼	礼 禮
神	神 𥛠
祥	祥
福	福 畗
靖	靖
精	精
羽	羽
諸	𢒕 诸
逸	逸 𤖍
都	都 𨛷
飯	饭
飼	飼 飤 饲
館	館 舘 馆
鶴	鹤
侮	㑄 㚢 𢘃
勤	懃 瘽
嘆	𡂥 歎 叹
器	噐 𡄛
層	层
屮	草
悔	𠧩
懲	惩
敏	勄
既	旣
梅	楳 某 槑
渚	陼
漢	㵄 𣶔 汉
煮	煑
爫	㕚 爪
社	𥙲 䄕 𥙭
祐	𨳾 佑
祖	𥘲
祝	𥘱
禍	旤 𥚍 𣨷 𥙯 祸
禎	祯
穀	糓 谷
突	𡦾
節	罇 卩 节
練	练
縉	缙
繁	緐
署	穎
艹	艸 草
艹	艸 草
著	着 螫
視	眎 𥄙 眡 𥄚 𥅭 𥉙 𤋇 视
謁	谒
謹	谨
賓	𧶉 𡫅 𥦎 𡧍 賔 宾
贈	赠
辶	辵
逸	逸 𤖍
難	𩁢 𩁬 𩀙 𩁣 𩁲 𩁩 𩀏 𩁤 难
響	𡪥 𡪆 响
頻	𩔤 频
恵	惠
𤋮	
舘	館
並	幷 并 竝
况	況
全	𠓴 㒰
啕	咷
塚	塚 中
墳	坆 坟 𡏶
奔	犇
徭	傜
慎	愼
愈	癒 愉 瘉
懲	惩
戴	𢨇
搜	捜 𢯱 𢲷
摒	屏 拼
晴	晴
朗	朗 𥇑 脼
望	朢 𦣠
歹	歺 𡰮
殺	殺 𢁛 𢽅 𢿹 𢽆 𢼡 𢿔 𧤿 杀
流	流 㳅
滋	𣳯 𦱳
漢	㵄 𣶔 汉
煮	煑
爵	𥥼 𩰧 𣡫 𠙘
犯	𤝑 𢒿
猪	猪 豬
甆	瓷
画	畫
益	益 𠍳
直	𣓟 𣖴
着	著
磌	𧰊
節	罇 卩 节
类	類
絛	縚 绦
練	练
缾	瓶
荒	𠃤 𠯚
華	崋 䔢 蕐 华
襁	繈 繦
覆	復 复
視	眎 𥄙 眡 𥄚 𥅭 𥉙 𤋇 视
調	调
諸	𢒕 诸
請	请
謁	谒
諾	喏 诺
諭	谕
謹	谨
變	変 𢒟 𢒪 𢒦 变
贈	赠
輸	输
遲	遅 邌 迟
鉶	铏
陼	渚
難	𩁢 𩁬 𩀙 𩁣 𩁲 𩁩 𩀏 𩁤 难
靖	靖
響	𡪥 𡪆 响
頋	顧
頻	𩔤 频
鬒	㐱
龜	𠃾 𠁴 𤕣 龟
𢡊	
𢡄	
𣏕	
䀹	睫
𥉉	
𥳐	
𧻓	
龎	龐 厐
